date,state,district,female,male,deaths
2018-01-01,Haryana,Panchkula,181,233,414
2018-01-01,Haryana,Ambala,388,562,950
2018-01-01,Haryana,Yamunanagar,402,582,984
2018-01-01,Haryana,Kurukshetra,303,410,713
2018-01-01,Haryana,Kaithal,248,422,670
2018-01-01,Haryana,Karnal,443,628,1071
2018-01-01,Haryana,Panipat,306,501,807
2018-01-01,Haryana,Sonipat,392,633,1025
2018-01-01,Haryana,Jind,319,504,823
2018-01-01,Haryana,Fatehabad,244,356,600
2018-01-01,Haryana,Sirsa,324,537,861
2018-01-01,Haryana,Hisar,566,1019,1585
2018-01-01,Haryana,Bhiwani,249,420,669
2018-01-01,Haryana,Rohtak,498,860,1358
2018-01-01,Haryana,Jhajjar,232,394,626
2018-01-01,Haryana,Mahendragarh,236,333,569
2018-01-01,Haryana,Rewari,262,369,631
2018-01-01,Haryana,Gurugram,416,786,1202
2018-01-01,Haryana,Nuh,146,271,417
2018-01-01,Haryana,Faridabad,410,744,1154
2018-01-01,Haryana,Palwal ,171,300,471
2018-01-01,Haryana,Charkhi Dadri,76,142,218
2018-02-01,Haryana,Panchkula,156,224,380
2018-02-01,Haryana,Ambala,362,437,799
2018-02-01,Haryana,Yamunanagar,301,452,753
2018-02-01,Haryana,Kurukshetra,231,343,574
2018-02-01,Haryana,Kaithal,230,427,657
2018-02-01,Haryana,Karnal,347,498,845
2018-02-01,Haryana,Panipat,260,430,690
2018-02-01,Haryana,Sonipat,300,485,785
2018-02-01,Haryana,Jind,278,450,728
2018-02-01,Haryana,Fatehabad,177,279,456
2018-02-01,Haryana,Sirsa,279,396,675
2018-02-01,Haryana,Hisar,464,787,1251
2018-02-01,Haryana,Bhiwani,196,339,535
2018-02-01,Haryana,Rohtak,380,746,1126
2018-02-01,Haryana,Jhajjar,186,310,496
2018-02-01,Haryana,Mahendragarh,182,313,495
2018-02-01,Haryana,Rewari,176,326,502
2018-02-01,Haryana,Gurugram,355,641,996
2018-02-01,Haryana,Nuh,141,259,400
2018-02-01,Haryana,Faridabad,319,585,904
2018-02-01,Haryana,Palwal ,153,244,397
2018-02-01,Haryana,Charkhi Dadri,65,105,170
2018-03-01,Haryana,Panchkula,128,211,339
2018-03-01,Haryana,Ambala,307,414,721
2018-03-01,Haryana,Yamunanagar,310,468,778
2018-03-01,Haryana,Kurukshetra,220,351,571
2018-03-01,Haryana,Kaithal,231,447,678
2018-03-01,Haryana,Karnal,327,558,885
2018-03-01,Haryana,Panipat,233,446,679
2018-03-01,Haryana,Sonipat,307,535,842
2018-03-01,Haryana,Jind,271,473,744
2018-03-01,Haryana,Fatehabad,196,291,487
2018-03-01,Haryana,Sirsa,248,404,652
2018-03-01,Haryana,Hisar,477,858,1335
2018-03-01,Haryana,Bhiwani,199,364,563
2018-03-01,Haryana,Rohtak,355,709,1064
2018-03-01,Haryana,Jhajjar,166,319,485
2018-03-01,Haryana,Mahendragarh,175,276,451
2018-03-01,Haryana,Rewari,150,295,445
2018-03-01,Haryana,Gurugram,324,589,913
2018-03-01,Haryana,Nuh,154,257,411
2018-03-01,Haryana,Faridabad,300,611,911
2018-03-01,Haryana,Palwal ,145,266,411
2018-03-01,Haryana,Charkhi Dadri,75,127,202
2018-04-01,Haryana,Panchkula,129,182,311
2018-04-01,Haryana,Ambala,266,443,709
2018-04-01,Haryana,Yamunanagar,268,431,699
2018-04-01,Haryana,Kurukshetra,195,313,508
2018-04-01,Haryana,Kaithal,212,375,587
2018-04-01,Haryana,Karnal,323,526,849
2018-04-01,Haryana,Panipat,207,383,590
2018-04-01,Haryana,Sonipat,255,514,769
2018-04-01,Haryana,Jind,253,433,686
2018-04-01,Haryana,Fatehabad,174,269,443
2018-04-01,Haryana,Sirsa,243,387,630
2018-04-01,Haryana,Hisar,417,780,1197
2018-04-01,Haryana,Bhiwani,195,326,521
2018-04-01,Haryana,Rohtak,366,652,1018
2018-04-01,Haryana,Jhajjar,177,301,478
2018-04-01,Haryana,Mahendragarh,191,265,456
2018-04-01,Haryana,Rewari,198,275,473
2018-04-01,Haryana,Gurugram,314,558,872
2018-04-01,Haryana,Nuh,132,257,389
2018-04-01,Haryana,Faridabad,304,468,772
2018-04-01,Haryana,Palwal ,157,278,435
2018-04-01,Haryana,Charkhi Dadri,58,130,188
2018-05-01,Haryana,Panchkula,107,202,309
2018-05-01,Haryana,Ambala,279,433,712
2018-05-01,Haryana,Yamunanagar,254,413,667
2018-05-01,Haryana,Kurukshetra,212,359,571
2018-05-01,Haryana,Kaithal,230,422,652
2018-05-01,Haryana,Karnal,348,572,920
2018-05-01,Haryana,Panipat,224,386,610
2018-05-01,Haryana,Sonipat,312,494,806
2018-05-01,Haryana,Jind,274,449,723
2018-05-01,Haryana,Fatehabad,202,275,477
2018-05-01,Haryana,Sirsa,250,407,657
2018-05-01,Haryana,Hisar,435,852,1287
2018-05-01,Haryana,Bhiwani,224,344,568
2018-05-01,Haryana,Rohtak,350,700,1050
2018-05-01,Haryana,Jhajjar,185,311,496
2018-05-01,Haryana,Mahendragarh,185,294,479
2018-05-01,Haryana,Rewari,199,290,489
2018-05-01,Haryana,Gurugram,338,578,916
2018-05-01,Haryana,Nuh,158,293,451
2018-05-01,Haryana,Faridabad,323,536,859
2018-05-01,Haryana,Palwal ,157,302,459
2018-05-01,Haryana,Charkhi Dadri,79,98,177
2018-06-01,Haryana,Panchkula,111,199,310
2018-06-01,Haryana,Ambala,268,459,727
2018-06-01,Haryana,Yamunanagar,250,395,645
2018-06-01,Haryana,Kurukshetra,211,338,549
2018-06-01,Haryana,Kaithal,226,406,632
2018-06-01,Haryana,Karnal,334,475,809
2018-06-01,Haryana,Panipat,240,465,705
2018-06-01,Haryana,Sonipat,322,518,840
2018-06-01,Haryana,Jind,253,464,717
2018-06-01,Haryana,Fatehabad,186,286,472
2018-06-01,Haryana,Sirsa,253,370,623
2018-06-01,Haryana,Hisar,512,860,1372
2018-06-01,Haryana,Bhiwani,229,360,589
2018-06-01,Haryana,Rohtak,395,753,1148
2018-06-01,Haryana,Jhajjar,217,328,545
2018-06-01,Haryana,Mahendragarh,189,345,534
2018-06-01,Haryana,Rewari,212,360,572
2018-06-01,Haryana,Gurugram,319,613,932
2018-06-01,Haryana,Nuh,153,281,434
2018-06-01,Haryana,Faridabad,344,596,940
2018-06-01,Haryana,Palwal ,155,295,450
2018-06-01,Haryana,Charkhi Dadri,95,132,227
2018-07-01,Haryana,Panchkula,124,196,320
2018-07-01,Haryana,Ambala,236,388,624
2018-07-01,Haryana,Yamunanagar,220,388,608
2018-07-01,Haryana,Kurukshetra,205,350,555
2018-07-01,Haryana,Kaithal,211,388,599
2018-07-01,Haryana,Karnal,287,483,770
2018-07-01,Haryana,Panipat,200,412,612
2018-07-01,Haryana,Sonipat,260,496,756
2018-07-01,Haryana,Jind,233,450,683
2018-07-01,Haryana,Fatehabad,178,276,454
2018-07-01,Haryana,Sirsa,208,393,601
2018-07-01,Haryana,Hisar,385,807,1192
2018-07-01,Haryana,Bhiwani,173,312,485
2018-07-01,Haryana,Rohtak,320,638,958
2018-07-01,Haryana,Jhajjar,130,290,420
2018-07-01,Haryana,Mahendragarh,162,290,452
2018-07-01,Haryana,Rewari,143,290,433
2018-07-01,Haryana,Gurugram,271,592,863
2018-07-01,Haryana,Nuh,133,256,389
2018-07-01,Haryana,Faridabad,270,471,741
2018-07-01,Haryana,Palwal ,133,318,451
2018-07-01,Haryana,Charkhi Dadri,61,88,149
2018-08-01,Haryana,Panchkula,108,193,301
2018-08-01,Haryana,Ambala,282,455,737
2018-08-01,Haryana,Yamunanagar,246,381,627
2018-08-01,Haryana,Kurukshetra,181,347,528
2018-08-01,Haryana,Kaithal,227,380,607
2018-08-01,Haryana,Karnal,317,536,853
2018-08-01,Haryana,Panipat,196,414,610
2018-08-01,Haryana,Sonipat,262,495,757
2018-08-01,Haryana,Jind,237,466,703
2018-08-01,Haryana,Fatehabad,163,291,454
2018-08-01,Haryana,Sirsa,209,385,594
2018-08-01,Haryana,Hisar,391,783,1174
2018-08-01,Haryana,Bhiwani,155,301,456
2018-08-01,Haryana,Rohtak,310,689,999
2018-08-01,Haryana,Jhajjar,154,268,422
2018-08-01,Haryana,Mahendragarh,158,261,419
2018-08-01,Haryana,Rewari,177,332,509
2018-08-01,Haryana,Gurugram,297,666,963
2018-08-01,Haryana,Nuh,174,277,451
2018-08-01,Haryana,Faridabad,326,548,874
2018-08-01,Haryana,Palwal ,145,292,437
2018-08-01,Haryana,Charkhi Dadri,70,103,173
2018-09-01,Haryana,Panchkula,129,204,333
2018-09-01,Haryana,Ambala,296,491,787
2018-09-01,Haryana,Yamunanagar,310,447,757
2018-09-01,Haryana,Kurukshetra,192,367,559
2018-09-01,Haryana,Kaithal,216,396,612
2018-09-01,Haryana,Karnal,349,608,957
2018-09-01,Haryana,Panipat,242,391,633
2018-09-01,Haryana,Sonipat,281,491,772
2018-09-01,Haryana,Jind,236,426,662
2018-09-01,Haryana,Fatehabad,160,253,413
2018-09-01,Haryana,Sirsa,232,364,596
2018-09-01,Haryana,Hisar,358,733,1091
2018-09-01,Haryana,Bhiwani,158,316,474
2018-09-01,Haryana,Rohtak,352,656,1008
2018-09-01,Haryana,Jhajjar,156,288,444
2018-09-01,Haryana,Mahendragarh,150,271,421
2018-09-01,Haryana,Rewari,176,308,484
2018-09-01,Haryana,Gurugram,372,718,1090
2018-09-01,Haryana,Nuh,181,281,462
2018-09-01,Haryana,Faridabad,326,582,908
2018-09-01,Haryana,Palwal ,175,272,447
2018-09-01,Haryana,Charkhi Dadri,71,98,169
2018-10-01,Haryana,Panchkula,123,253,376
2018-10-01,Haryana,Ambala,305,542,847
2018-10-01,Haryana,Yamunanagar,292,466,758
2018-10-01,Haryana,Kurukshetra,242,397,639
2018-10-01,Haryana,Kaithal,278,467,745
2018-10-01,Haryana,Karnal,444,749,1193
2018-10-01,Haryana,Panipat,256,446,702
2018-10-01,Haryana,Sonipat,304,539,843
2018-10-01,Haryana,Jind,270,487,757
2018-10-01,Haryana,Fatehabad,194,312,506
2018-10-01,Haryana,Sirsa,260,459,719
2018-10-01,Haryana,Hisar,442,875,1317
2018-10-01,Haryana,Bhiwani,199,344,543
2018-10-01,Haryana,Rohtak,349,767,1116
2018-10-01,Haryana,Jhajjar,184,271,455
2018-10-01,Haryana,Mahendragarh,167,288,455
2018-10-01,Haryana,Rewari,179,317,496
2018-10-01,Haryana,Gurugram,327,759,1086
2018-10-01,Haryana,Nuh,158,266,424
2018-10-01,Haryana,Faridabad,341,606,947
2018-10-01,Haryana,Palwal ,167,290,457
2018-10-01,Haryana,Charkhi Dadri,74,109,183
2018-11-01,Haryana,Panchkula,139,204,343
2018-11-01,Haryana,Ambala,341,466,807
2018-11-01,Haryana,Yamunanagar,289,539,828
2018-11-01,Haryana,Kurukshetra,248,419,667
2018-11-01,Haryana,Kaithal,280,486,766
2018-11-01,Haryana,Karnal,388,629,1017
2018-11-01,Haryana,Panipat,245,521,766
2018-11-01,Haryana,Sonipat,294,585,879
2018-11-01,Haryana,Jind,275,539,814
2018-11-01,Haryana,Fatehabad,211,359,570
2018-11-01,Haryana,Sirsa,271,420,691
2018-11-01,Haryana,Hisar,481,873,1354
2018-11-01,Haryana,Bhiwani,223,389,612
2018-11-01,Haryana,Rohtak,392,774,1166
2018-11-01,Haryana,Jhajjar,187,322,509
2018-11-01,Haryana,Mahendragarh,175,294,469
2018-11-01,Haryana,Rewari,180,328,508
2018-11-01,Haryana,Gurugram,373,694,1067
2018-11-01,Haryana,Nuh,151,287,438
2018-11-01,Haryana,Faridabad,334,625,959
2018-11-01,Haryana,Palwal ,186,336,522
2018-11-01,Haryana,Charkhi Dadri,68,121,189
2018-12-01,Haryana,Panchkula,152,238,390
2018-12-01,Haryana,Ambala,358,595,953
2018-12-01,Haryana,Yamunanagar,317,525,842
2018-12-01,Haryana,Kurukshetra,276,417,693
2018-12-01,Haryana,Kaithal,256,503,759
2018-12-01,Haryana,Karnal,417,643,1060
2018-12-01,Haryana,Panipat,251,495,746
2018-12-01,Haryana,Sonipat,355,600,955
2018-12-01,Haryana,Jind,276,518,794
2018-12-01,Haryana,Fatehabad,228,312,540
2018-12-01,Haryana,Sirsa,282,451,733
2018-12-01,Haryana,Hisar,516,962,1478
2018-12-01,Haryana,Bhiwani,223,373,596
2018-12-01,Haryana,Rohtak,364,745,1109
2018-12-01,Haryana,Jhajjar,213,406,619
2018-12-01,Haryana,Mahendragarh,185,320,505
2018-12-01,Haryana,Rewari,201,351,552
2018-12-01,Haryana,Gurugram,379,705,1084
2018-12-01,Haryana,Nuh,133,317,450
2018-12-01,Haryana,Faridabad,368,677,1045
2018-12-01,Haryana,Palwal ,176,292,468
2018-12-01,Haryana,Charkhi Dadri,92,138,230
2019-01-01,Haryana,Panchkula,170,283,453
2019-01-01,Haryana,Ambala,425,563,988
2019-01-01,Haryana,Yamunanagar,367,531,898
2019-01-01,Haryana,Kurukshetra,261,443,704
2019-01-01,Haryana,Kaithal,298,494,792
2019-01-01,Haryana,Karnal,418,645,1063
2019-01-01,Haryana,Panipat,287,482,769
2019-01-01,Haryana,Sonipat,359,584,943
2019-01-01,Haryana,Jind,311,567,878
2019-01-01,Haryana,Fatehabad,222,345,567
2019-01-01,Haryana,Sirsa,330,511,841
2019-01-01,Haryana,Hisar,569,1080,1649
2019-01-01,Haryana,Bhiwani,255,424,679
2019-01-01,Haryana,Rohtak,401,803,1204
2019-01-01,Haryana,Jhajjar,232,400,632
2019-01-01,Haryana,Mahendragarh,206,365,571
2019-01-01,Haryana,Rewari,230,358,588
2019-01-01,Haryana,Gurugram,415,812,1227
2019-01-01,Haryana,Nuh,132,268,400
2019-01-01,Haryana,Faridabad,379,672,1051
2019-01-01,Haryana,Palwal ,176,327,503
2019-01-01,Haryana,Charkhi Dadri,97,141,238
2019-02-01,Haryana,Panchkula,161,225,386
2019-02-01,Haryana,Ambala,351,510,861
2019-02-01,Haryana,Yamunanagar,319,480,799
2019-02-01,Haryana,Kurukshetra,251,386,637
2019-02-01,Haryana,Kaithal,245,410,655
2019-02-01,Haryana,Karnal,353,557,910
2019-02-01,Haryana,Panipat,234,403,637
2019-02-01,Haryana,Sonipat,391,504,895
2019-02-01,Haryana,Jind,260,428,688
2019-02-01,Haryana,Fatehabad,232,278,510
2019-02-01,Haryana,Sirsa,331,477,808
2019-02-01,Haryana,Hisar,516,892,1408
2019-02-01,Haryana,Bhiwani,206,364,570
2019-02-01,Haryana,Rohtak,372,682,1054
2019-02-01,Haryana,Jhajjar,198,315,513
2019-02-01,Haryana,Mahendragarh,165,272,437
2019-02-01,Haryana,Rewari,210,345,555
2019-02-01,Haryana,Gurugram,354,708,1062
2019-02-01,Haryana,Nuh,115,212,327
2019-02-01,Haryana,Faridabad,366,540,906
2019-02-01,Haryana,Palwal ,171,298,469
2019-02-01,Haryana,Charkhi Dadri,68,113,181
2019-03-01,Haryana,Panchkula,138,221,359
2019-03-01,Haryana,Ambala,373,494,867
2019-03-01,Haryana,Yamunanagar,324,536,860
2019-03-01,Haryana,Kurukshetra,235,360,595
2019-03-01,Haryana,Kaithal,259,421,680
2019-03-01,Haryana,Karnal,335,613,948
2019-03-01,Haryana,Panipat,250,451,701
2019-03-01,Haryana,Sonipat,302,575,877
2019-03-01,Haryana,Jind,273,470,743
2019-03-01,Haryana,Fatehabad,193,292,485
2019-03-01,Haryana,Sirsa,277,433,710
2019-03-01,Haryana,Hisar,480,901,1381
2019-03-01,Haryana,Bhiwani,217,363,580
2019-03-01,Haryana,Rohtak,375,705,1080
2019-03-01,Haryana,Jhajjar,176,306,482
2019-03-01,Haryana,Mahendragarh,178,271,449
2019-03-01,Haryana,Rewari,169,312,481
2019-03-01,Haryana,Gurugram,371,705,1076
2019-03-01,Haryana,Nuh,114,261,375
2019-03-01,Haryana,Faridabad,334,614,948
2019-03-01,Haryana,Palwal ,173,277,450
2019-03-01,Haryana,Charkhi Dadri,75,114,189
2019-04-01,Haryana,Panchkula,104,187,291
2019-04-01,Haryana,Ambala,248,436,684
2019-04-01,Haryana,Yamunanagar,270,431,701
2019-04-01,Haryana,Kurukshetra,196,289,485
2019-04-01,Haryana,Kaithal,215,388,603
2019-04-01,Haryana,Karnal,306,515,821
2019-04-01,Haryana,Panipat,212,406,618
2019-04-01,Haryana,Sonipat,288,449,737
2019-04-01,Haryana,Jind,260,419,679
2019-04-01,Haryana,Fatehabad,162,287,449
2019-04-01,Haryana,Sirsa,233,391,624
2019-04-01,Haryana,Hisar,398,843,1241
2019-04-01,Haryana,Bhiwani,198,360,558
2019-04-01,Haryana,Rohtak,361,633,994
2019-04-01,Haryana,Jhajjar,167,298,465
2019-04-01,Haryana,Mahendragarh,163,251,414
2019-04-01,Haryana,Rewari,174,289,463
2019-04-01,Haryana,Gurugram,345,615,960
2019-04-01,Haryana,Nuh,148,241,389
2019-04-01,Haryana,Faridabad,332,522,854
2019-04-01,Haryana,Palwal ,162,287,449
2019-04-01,Haryana,Charkhi Dadri,73,106,179
2019-05-01,Haryana,Panchkula,122,191,313
2019-05-01,Haryana,Ambala,296,485,781
2019-05-01,Haryana,Yamunanagar,271,454,725
2019-05-01,Haryana,Kurukshetra,201,336,537
2019-05-01,Haryana,Kaithal,267,390,657
2019-05-01,Haryana,Karnal,305,550,855
2019-05-01,Haryana,Panipat,220,416,636
2019-05-01,Haryana,Sonipat,262,506,768
2019-05-01,Haryana,Jind,261,481,742
2019-05-01,Haryana,Fatehabad,191,305,496
2019-05-01,Haryana,Sirsa,273,433,706
2019-05-01,Haryana,Hisar,471,847,1318
2019-05-01,Haryana,Bhiwani,209,377,586
2019-05-01,Haryana,Rohtak,384,714,1098
2019-05-01,Haryana,Jhajjar,179,349,528
2019-05-01,Haryana,Mahendragarh,223,296,519
2019-05-01,Haryana,Rewari,209,291,500
2019-05-01,Haryana,Gurugram,357,585,942
2019-05-01,Haryana,Nuh,147,251,398
2019-05-01,Haryana,Faridabad,314,561,875
2019-05-01,Haryana,Palwal ,141,294,435
2019-05-01,Haryana,Charkhi Dadri,65,150,215
2019-06-01,Haryana,Panchkula,124,188,312
2019-06-01,Haryana,Ambala,330,483,813
2019-06-01,Haryana,Yamunanagar,296,424,720
2019-06-01,Haryana,Kurukshetra,187,350,537
2019-06-01,Haryana,Kaithal,250,404,654
2019-06-01,Haryana,Karnal,306,537,843
2019-06-01,Haryana,Panipat,255,404,659
2019-06-01,Haryana,Sonipat,312,517,829
2019-06-01,Haryana,Jind,326,467,793
2019-06-01,Haryana,Fatehabad,203,295,498
2019-06-01,Haryana,Sirsa,279,453,732
2019-06-01,Haryana,Hisar,520,881,1401
2019-06-01,Haryana,Bhiwani,220,392,612
2019-06-01,Haryana,Rohtak,347,683,1030
2019-06-01,Haryana,Jhajjar,215,329,544
2019-06-01,Haryana,Mahendragarh,208,321,529
2019-06-01,Haryana,Rewari,196,327,523
2019-06-01,Haryana,Gurugram,333,611,944
2019-06-01,Haryana,Nuh,145,252,397
2019-06-01,Haryana,Faridabad,298,600,898
2019-06-01,Haryana,Palwal ,190,305,495
2019-06-01,Haryana,Charkhi Dadri,67,116,183
2019-07-01,Haryana,Panchkula,122,206,328
2019-07-01,Haryana,Ambala,285,477,762
2019-07-01,Haryana,Yamunanagar,253,436,689
2019-07-01,Haryana,Kurukshetra,205,331,536
2019-07-01,Haryana,Kaithal,221,423,644
2019-07-01,Haryana,Karnal,318,516,834
2019-07-01,Haryana,Panipat,205,349,554
2019-07-01,Haryana,Sonipat,266,507,773
2019-07-01,Haryana,Jind,251,469,720
2019-07-01,Haryana,Fatehabad,156,249,405
2019-07-01,Haryana,Sirsa,258,427,685
2019-07-01,Haryana,Hisar,376,779,1155
2019-07-01,Haryana,Bhiwani,180,307,487
2019-07-01,Haryana,Rohtak,309,674,983
2019-07-01,Haryana,Jhajjar,142,285,427
2019-07-01,Haryana,Mahendragarh,124,235,359
2019-07-01,Haryana,Rewari,156,281,437
2019-07-01,Haryana,Gurugram,270,572,842
2019-07-01,Haryana,Nuh,133,267,400
2019-07-01,Haryana,Faridabad,295,586,881
2019-07-01,Haryana,Palwal ,154,271,425
2019-07-01,Haryana,Charkhi Dadri,63,97,160
2019-08-01,Haryana,Panchkula,112,222,334
2019-08-01,Haryana,Ambala,285,463,748
2019-08-01,Haryana,Yamunanagar,264,467,731
2019-08-01,Haryana,Kurukshetra,206,369,575
2019-08-01,Haryana,Kaithal,235,470,705
2019-08-01,Haryana,Karnal,363,562,925
2019-08-01,Haryana,Panipat,232,378,610
2019-08-01,Haryana,Sonipat,279,581,860
2019-08-01,Haryana,Jind,274,477,751
2019-08-01,Haryana,Fatehabad,174,333,507
2019-08-01,Haryana,Sirsa,239,419,658
2019-08-01,Haryana,Hisar,474,858,1332
2019-08-01,Haryana,Bhiwani,174,357,531
2019-08-01,Haryana,Rohtak,399,703,1102
2019-08-01,Haryana,Jhajjar,156,293,449
2019-08-01,Haryana,Mahendragarh,177,299,476
2019-08-01,Haryana,Rewari,184,325,509
2019-08-01,Haryana,Gurugram,331,625,956
2019-08-01,Haryana,Nuh,174,291,465
2019-08-01,Haryana,Faridabad,318,639,957
2019-08-01,Haryana,Palwal ,163,320,483
2019-08-01,Haryana,Charkhi Dadri,67,140,207
2019-09-01,Haryana,Panchkula,136,203,339
2019-09-01,Haryana,Ambala,319,472,791
2019-09-01,Haryana,Yamunanagar,269,432,701
2019-09-01,Haryana,Kurukshetra,213,327,540
2019-09-01,Haryana,Kaithal,237,418,655
2019-09-01,Haryana,Karnal,367,595,962
2019-09-01,Haryana,Panipat,230,430,660
2019-09-01,Haryana,Sonipat,316,545,861
2019-09-01,Haryana,Jind,243,479,722
2019-09-01,Haryana,Fatehabad,187,281,468
2019-09-01,Haryana,Sirsa,242,452,694
2019-09-01,Haryana,Hisar,491,855,1346
2019-09-01,Haryana,Bhiwani,177,316,493
2019-09-01,Haryana,Rohtak,347,767,1114
2019-09-01,Haryana,Jhajjar,160,338,498
2019-09-01,Haryana,Mahendragarh,178,325,503
2019-09-01,Haryana,Rewari,213,319,532
2019-09-01,Haryana,Gurugram,311,631,942
2019-09-01,Haryana,Nuh,157,276,433
2019-09-01,Haryana,Faridabad,363,579,942
2019-09-01,Haryana,Palwal ,155,310,465
2019-09-01,Haryana,Charkhi Dadri,71,129,200
2019-10-01,Haryana,Panchkula,143,224,367
2019-10-01,Haryana,Ambala,361,603,964
2019-10-01,Haryana,Yamunanagar,273,490,763
2019-10-01,Haryana,Kurukshetra,189,361,550
2019-10-01,Haryana,Kaithal,244,412,656
2019-10-01,Haryana,Karnal,377,566,943
2019-10-01,Haryana,Panipat,241,432,673
2019-10-01,Haryana,Sonipat,303,515,818
2019-10-01,Haryana,Jind,251,473,724
2019-10-01,Haryana,Fatehabad,176,304,480
2019-10-01,Haryana,Sirsa,270,473,743
2019-10-01,Haryana,Hisar,464,876,1340
2019-10-01,Haryana,Bhiwani,202,366,568
2019-10-01,Haryana,Rohtak,316,699,1015
2019-10-01,Haryana,Jhajjar,154,324,478
2019-10-01,Haryana,Mahendragarh,162,317,479
2019-10-01,Haryana,Rewari,162,301,463
2019-10-01,Haryana,Gurugram,352,639,991
2019-10-01,Haryana,Nuh,149,271,420
2019-10-01,Haryana,Faridabad,306,587,893
2019-10-01,Haryana,Palwal ,141,333,474
2019-10-01,Haryana,Charkhi Dadri,66,135,201
2019-11-01,Haryana,Panchkula,142,248,390
2019-11-01,Haryana,Ambala,349,540,889
2019-11-01,Haryana,Yamunanagar,350,512,862
2019-11-01,Haryana,Kurukshetra,231,383,614
2019-11-01,Haryana,Kaithal,247,421,668
2019-11-01,Haryana,Karnal,379,657,1036
2019-11-01,Haryana,Panipat,234,475,709
2019-11-01,Haryana,Sonipat,294,572,866
2019-11-01,Haryana,Jind,256,466,722
2019-11-01,Haryana,Fatehabad,215,348,563
2019-11-01,Haryana,Sirsa,319,494,813
2019-11-01,Haryana,Hisar,508,881,1389
2019-11-01,Haryana,Bhiwani,208,404,612
2019-11-01,Haryana,Rohtak,346,674,1020
2019-11-01,Haryana,Jhajjar,177,316,493
2019-11-01,Haryana,Mahendragarh,153,251,404
2019-11-01,Haryana,Rewari,160,343,503
2019-11-01,Haryana,Gurugram,304,605,909
2019-11-01,Haryana,Nuh,153,289,442
2019-11-01,Haryana,Faridabad,342,604,946
2019-11-01,Haryana,Palwal ,145,309,454
2019-11-01,Haryana,Charkhi Dadri,75,148,223
2019-12-01,Haryana,Panchkula,174,255,429
2019-12-01,Haryana,Ambala,431,636,1067
2019-12-01,Haryana,Yamunanagar,325,587,912
2019-12-01,Haryana,Kurukshetra,282,460,742
2019-12-01,Haryana,Kaithal,298,516,814
2019-12-01,Haryana,Karnal,431,675,1106
2019-12-01,Haryana,Panipat,298,541,839
2019-12-01,Haryana,Sonipat,356,699,1055
2019-12-01,Haryana,Jind,313,550,863
2019-12-01,Haryana,Fatehabad,283,404,687
2019-12-01,Haryana,Sirsa,369,570,939
2019-12-01,Haryana,Hisar,589,1013,1602
2019-12-01,Haryana,Bhiwani,275,464,739
2019-12-01,Haryana,Rohtak,458,839,1297
2019-12-01,Haryana,Jhajjar,204,399,603
2019-12-01,Haryana,Mahendragarh,221,410,631
2019-12-01,Haryana,Rewari,253,410,663
2019-12-01,Haryana,Gurugram,401,726,1127
2019-12-01,Haryana,Nuh,168,307,475
2019-12-01,Haryana,Faridabad,402,711,1113
2019-12-01,Haryana,Palwal ,191,349,540
2019-12-01,Haryana,Charkhi Dadri,118,230,348
2020-01-01,Haryana,Panchkula,176,278,454
2020-01-01,Haryana,Ambala,425,646,1071
2020-01-01,Haryana,Yamunanagar,354,607,961
2020-01-01,Haryana,Kurukshetra,320,444,764
2020-01-01,Haryana,Kaithal,340,516,856
2020-01-01,Haryana,Karnal,456,678,1134
2020-01-01,Haryana,Panipat,286,558,844
2020-01-01,Haryana,Sonipat,383,700,1083
2020-01-01,Haryana,Jind,355,504,859
2020-01-01,Haryana,Fatehabad,293,375,668
2020-01-01,Haryana,Sirsa,382,566,948
2020-01-01,Haryana,Hisar,601,1005,1606
2020-01-01,Haryana,Bhiwani,340,436,776
2020-01-01,Haryana,Rohtak,464,888,1352
2020-01-01,Haryana,Jhajjar,227,413,640
2020-01-01,Haryana,Mahendragarh,223,337,560
2020-01-01,Haryana,Rewari,265,409,674
2020-01-01,Haryana,Gurugram,509,821,1330
2020-01-01,Haryana,Nuh,204,295,499
2020-01-01,Haryana,Faridabad,402,713,1115
2020-01-01,Haryana,Palwal ,192,363,555
2020-01-01,Haryana,Charkhi Dadri,120,197,317
2020-02-01,Haryana,Panchkula,161,219,380
2020-02-01,Haryana,Ambala,362,549,911
2020-02-01,Haryana,Yamunanagar,289,448,737
2020-02-01,Haryana,Kurukshetra,246,375,621
2020-02-01,Haryana,Kaithal,266,385,651
2020-02-01,Haryana,Karnal,356,590,946
2020-02-01,Haryana,Panipat,243,449,692
2020-02-01,Haryana,Sonipat,353,571,924
2020-02-01,Haryana,Jind,260,464,724
2020-02-01,Haryana,Fatehabad,202,317,519
2020-02-01,Haryana,Sirsa,287,399,686
2020-02-01,Haryana,Hisar,475,842,1317
2020-02-01,Haryana,Bhiwani,235,364,599
2020-02-01,Haryana,Rohtak,508,906,1414
2020-02-01,Haryana,Jhajjar,179,325,504
2020-02-01,Haryana,Mahendragarh,180,284,464
2020-02-01,Haryana,Rewari,203,290,493
2020-02-01,Haryana,Gurugram,358,694,1052
2020-02-01,Haryana,Nuh,166,254,420
2020-02-01,Haryana,Faridabad,363,622,985
2020-02-01,Haryana,Palwal ,173,307,480
2020-02-01,Haryana,Charkhi Dadri,98,140,238
2020-03-01,Haryana,Panchkula,133,229,362
2020-03-01,Haryana,Ambala,292,413,705
2020-03-01,Haryana,Yamunanagar,281,439,720
2020-03-01,Haryana,Kurukshetra,249,316,565
2020-03-01,Haryana,Kaithal,236,380,616
2020-03-01,Haryana,Karnal,349,559,908
2020-03-01,Haryana,Panipat,243,450,693
2020-03-01,Haryana,Sonipat,292,562,854
2020-03-01,Haryana,Jind,262,418,680
2020-03-01,Haryana,Fatehabad,185,288,473
2020-03-01,Haryana,Sirsa,301,425,726
2020-03-01,Haryana,Hisar,452,930,1382
2020-03-01,Haryana,Bhiwani,232,323,555
2020-03-01,Haryana,Rohtak,436,861,1297
2020-03-01,Haryana,Jhajjar,153,301,454
2020-03-01,Haryana,Mahendragarh,162,252,414
2020-03-01,Haryana,Rewari,200,304,504
2020-03-01,Haryana,Gurugram,323,623,946
2020-03-01,Haryana,Nuh,150,218,368
2020-03-01,Haryana,Faridabad,302,603,905
2020-03-01,Haryana,Palwal ,164,273,437
2020-03-01,Haryana,Charkhi Dadri,77,146,223
2020-04-01,Haryana,Panchkula,107,182,289
2020-04-01,Haryana,Ambala,258,322,580
2020-04-01,Haryana,Yamunanagar,238,394,632
2020-04-01,Haryana,Kurukshetra,174,263,437
2020-04-01,Haryana,Kaithal,227,374,601
2020-04-01,Haryana,Karnal,289,451,740
2020-04-01,Haryana,Panipat,234,323,557
2020-04-01,Haryana,Sonipat,281,492,773
2020-04-01,Haryana,Jind,240,389,629
2020-04-01,Haryana,Fatehabad,178,306,484
2020-04-01,Haryana,Sirsa,303,414,717
2020-04-01,Haryana,Hisar,400,672,1072
2020-04-01,Haryana,Bhiwani,200,334,534
2020-04-01,Haryana,Rohtak,421,611,1032
2020-04-01,Haryana,Jhajjar,162,277,439
2020-04-01,Haryana,Mahendragarh,168,244,412
2020-04-01,Haryana,Rewari,197,284,481
2020-04-01,Haryana,Gurugram,311,504,815
2020-04-01,Haryana,Nuh,108,214,322
2020-04-01,Haryana,Faridabad,294,458,752
2020-04-01,Haryana,Palwal ,193,259,452
2020-04-01,Haryana,Charkhi Dadri,89,126,215
2020-05-01,Haryana,Panchkula,146,197,343
2020-05-01,Haryana,Ambala,308,444,752
2020-05-01,Haryana,Yamunanagar,280,407,687
2020-05-01,Haryana,Kurukshetra,250,335,585
2020-05-01,Haryana,Kaithal,236,397,633
2020-05-01,Haryana,Karnal,380,548,928
2020-05-01,Haryana,Panipat,249,453,702
2020-05-01,Haryana,Sonipat,373,513,886
2020-05-01,Haryana,Jind,295,501,796
2020-05-01,Haryana,Fatehabad,196,295,491
2020-05-01,Haryana,Sirsa,293,470,763
2020-05-01,Haryana,Hisar,417,819,1236
2020-05-01,Haryana,Bhiwani,231,398,629
2020-05-01,Haryana,Rohtak,480,816,1296
2020-05-01,Haryana,Jhajjar,197,365,562
2020-05-01,Haryana,Mahendragarh,210,291,501
2020-05-01,Haryana,Rewari,240,302,542
2020-05-01,Haryana,Gurugram,370,611,981
2020-05-01,Haryana,Nuh,159,232,391
2020-05-01,Haryana,Faridabad,385,587,972
2020-05-01,Haryana,Palwal ,208,304,512
2020-05-01,Haryana,Charkhi Dadri,110,157,267
2020-06-01,Haryana,Panchkula,112,195,307
2020-06-01,Haryana,Ambala,264,458,722
2020-06-01,Haryana,Yamunanagar,245,383,628
2020-06-01,Haryana,Kurukshetra,210,355,565
2020-06-01,Haryana,Kaithal,231,413,644
2020-06-01,Haryana,Karnal,353,567,920
2020-06-01,Haryana,Panipat,265,433,698
2020-06-01,Haryana,Sonipat,343,586,929
2020-06-01,Haryana,Jind,254,468,722
2020-06-01,Haryana,Fatehabad,179,301,480
2020-06-01,Haryana,Sirsa,260,459,719
2020-06-01,Haryana,Hisar,445,858,1303
2020-06-01,Haryana,Bhiwani,223,375,598
2020-06-01,Haryana,Rohtak,426,804,1230
2020-06-01,Haryana,Jhajjar,195,327,522
2020-06-01,Haryana,Mahendragarh,183,291,474
2020-06-01,Haryana,Rewari,184,296,480
2020-06-01,Haryana,Gurugram,391,778,1169
2020-06-01,Haryana,Nuh,167,277,444
2020-06-01,Haryana,Faridabad,457,780,1237
2020-06-01,Haryana,Palwal ,175,327,502
2020-06-01,Haryana,Charkhi Dadri,76,127,203
2020-07-01,Haryana,Panchkula,125,214,339
2020-07-01,Haryana,Ambala,291,450,741
2020-07-01,Haryana,Yamunanagar,232,391,623
2020-07-01,Haryana,Kurukshetra,223,339,562
2020-07-01,Haryana,Kaithal,248,441,689
2020-07-01,Haryana,Karnal,369,648,1017
2020-07-01,Haryana,Panipat,247,491,738
2020-07-01,Haryana,Sonipat,311,578,889
2020-07-01,Haryana,Jind,274,502,776
2020-07-01,Haryana,Fatehabad,210,344,554
2020-07-01,Haryana,Sirsa,286,461,747
2020-07-01,Haryana,Hisar,463,854,1317
2020-07-01,Haryana,Bhiwani,234,383,617
2020-07-01,Haryana,Rohtak,439,843,1282
2020-07-01,Haryana,Jhajjar,190,365,555
2020-07-01,Haryana,Mahendragarh,145,278,423
2020-07-01,Haryana,Rewari,139,293,432
2020-07-01,Haryana,Gurugram,328,627,955
2020-07-01,Haryana,Nuh,152,313,465
2020-07-01,Haryana,Faridabad,398,748,1146
2020-07-01,Haryana,Palwal ,168,310,478
2020-07-01,Haryana,Charkhi Dadri,101,144,245
2020-08-01,Haryana,Panchkula,172,289,461
2020-08-01,Haryana,Ambala,293,481,774
2020-08-01,Haryana,Yamunanagar,284,483,767
2020-08-01,Haryana,Kurukshetra,242,399,641
2020-08-01,Haryana,Kaithal,252,411,663
2020-08-01,Haryana,Karnal,374,635,1009
2020-08-01,Haryana,Panipat,298,530,828
2020-08-01,Haryana,Sonipat,300,550,850
2020-08-01,Haryana,Jind,249,532,781
2020-08-01,Haryana,Fatehabad,158,296,454
2020-08-01,Haryana,Sirsa,287,422,709
2020-08-01,Haryana,Hisar,457,882,1339
2020-08-01,Haryana,Bhiwani,220,356,576
2020-08-01,Haryana,Rohtak,370,718,1088
2020-08-01,Haryana,Jhajjar,164,316,480
2020-08-01,Haryana,Mahendragarh,140,293,433
2020-08-01,Haryana,Rewari,175,321,496
2020-08-01,Haryana,Gurugram,370,680,1050
2020-08-01,Haryana,Nuh,161,297,458
2020-08-01,Haryana,Faridabad,344,679,1023
2020-08-01,Haryana,Palwal ,157,302,459
2020-08-01,Haryana,Charkhi Dadri,70,172,242
2020-09-01,Haryana,Panchkula,211,315,526
2020-09-01,Haryana,Ambala,444,676,1120
2020-09-01,Haryana,Yamunanagar,361,581,942
2020-09-01,Haryana,Kurukshetra,261,435,696
2020-09-01,Haryana,Kaithal,293,468,761
2020-09-01,Haryana,Karnal,431,784,1215
2020-09-01,Haryana,Panipat,320,518,838
2020-09-01,Haryana,Sonipat,279,566,845
2020-09-01,Haryana,Jind,269,465,734
2020-09-01,Haryana,Fatehabad,182,304,486
2020-09-01,Haryana,Sirsa,270,505,775
2020-09-01,Haryana,Hisar,505,952,1457
2020-09-01,Haryana,Bhiwani,232,365,597
2020-09-01,Haryana,Rohtak,381,712,1093
2020-09-01,Haryana,Jhajjar,207,362,569
2020-09-01,Haryana,Mahendragarh,198,293,491
2020-09-01,Haryana,Rewari,202,343,545
2020-09-01,Haryana,Gurugram,373,820,1193
2020-09-01,Haryana,Nuh,160,313,473
2020-09-01,Haryana,Faridabad,396,744,1140
2020-09-01,Haryana,Palwal ,182,347,529
2020-09-01,Haryana,Charkhi Dadri,76,152,228
2020-10-01,Haryana,Panchkula,176,294,470
2020-10-01,Haryana,Ambala,359,568,927
2020-10-01,Haryana,Yamunanagar,305,524,829
2020-10-01,Haryana,Kurukshetra,219,401,620
2020-10-01,Haryana,Kaithal,264,453,717
2020-10-01,Haryana,Karnal,387,664,1051
2020-10-01,Haryana,Panipat,311,554,865
2020-10-01,Haryana,Sonipat,315,554,869
2020-10-01,Haryana,Jind,293,468,761
2020-10-01,Haryana,Fatehabad,182,367,549
2020-10-01,Haryana,Sirsa,303,456,759
2020-10-01,Haryana,Hisar,517,1002,1519
2020-10-01,Haryana,Bhiwani,209,371,580
2020-10-01,Haryana,Rohtak,399,745,1144
2020-10-01,Haryana,Jhajjar,188,372,560
2020-10-01,Haryana,Mahendragarh,186,255,441
2020-10-01,Haryana,Rewari,203,331,534
2020-10-01,Haryana,Gurugram,399,801,1200
2020-10-01,Haryana,Nuh,173,277,450
2020-10-01,Haryana,Faridabad,342,689,1031
2020-10-01,Haryana,Palwal ,187,317,504
2020-10-01,Haryana,Charkhi Dadri,85,146,231
2020-11-01,Haryana,Panchkula,202,324,526
2020-11-01,Haryana,Ambala,410,622,1032
2020-11-01,Haryana,Yamunanagar,333,558,891
2020-11-01,Haryana,Kurukshetra,287,423,710
2020-11-01,Haryana,Kaithal,299,498,797
2020-11-01,Haryana,Karnal,414,750,1164
2020-11-01,Haryana,Panipat,355,620,975
2020-11-01,Haryana,Sonipat,430,758,1188
2020-11-01,Haryana,Jind,328,559,887
2020-11-01,Haryana,Fatehabad,288,422,710
2020-11-01,Haryana,Sirsa,383,526,909
2020-11-01,Haryana,Hisar,690,1185,1875
2020-11-01,Haryana,Bhiwani,280,472,752
2020-11-01,Haryana,Rohtak,458,905,1363
2020-11-01,Haryana,Jhajjar,256,471,727
2020-11-01,Haryana,Mahendragarh,236,386,622
2020-11-01,Haryana,Rewari,227,435,662
2020-11-01,Haryana,Gurugram,487,1020,1507
2020-11-01,Haryana,Nuh,150,324,474
2020-11-01,Haryana,Faridabad,537,983,1520
2020-11-01,Haryana,Palwal ,198,381,579
2020-11-01,Haryana,Charkhi Dadri,118,206,324
2020-12-01,Haryana,Panchkula,225,343,568
2020-12-01,Haryana,Ambala,500,616,1116
2020-12-01,Haryana,Yamunanagar,379,583,962
2020-12-01,Haryana,Kurukshetra,332,442,774
2020-12-01,Haryana,Kaithal,333,512,845
2020-12-01,Haryana,Karnal,489,705,1194
2020-12-01,Haryana,Panipat,359,590,949
2020-12-01,Haryana,Sonipat,357,674,1031
2020-12-01,Haryana,Jind,323,564,887
2020-12-01,Haryana,Fatehabad,253,384,637
2020-12-01,Haryana,Sirsa,350,585,935
2020-12-01,Haryana,Hisar,586,1057,1643
2020-12-01,Haryana,Bhiwani,273,426,699
2020-12-01,Haryana,Rohtak,410,865,1275
2020-12-01,Haryana,Jhajjar,237,415,652
2020-12-01,Haryana,Mahendragarh,228,357,585
2020-12-01,Haryana,Rewari,218,411,629
2020-12-01,Haryana,Gurugram,495,910,1405
2020-12-01,Haryana,Nuh,178,305,483
2020-12-01,Haryana,Faridabad,479,770,1249
2020-12-01,Haryana,Palwal ,207,429,636
2020-12-01,Haryana,Charkhi Dadri,126,188,314
2021-01-01,Haryana,Panchkula,191,297,488
2021-01-01,Haryana,Ambala,386,565,951
2021-01-01,Haryana,Yamunanagar,327,521,848
2021-01-01,Haryana,Kurukshetra,269,439,708
2021-01-01,Haryana,Kaithal,305,435,740
2021-01-01,Haryana,Karnal,436,683,1119
2021-01-01,Haryana,Panipat,295,565,860
2021-01-01,Haryana,Sonipat,390,600,990
2021-01-01,Haryana,Jind,330,577,907
2021-01-01,Haryana,Fatehabad,226,374,600
2021-01-01,Haryana,Sirsa,330,530,860
2021-01-01,Haryana,Hisar,564,974,1538
2021-01-01,Haryana,Bhiwani,293,424,717
2021-01-01,Haryana,Rohtak,392,763,1155
2021-01-01,Haryana,Jhajjar,227,370,597
2021-01-01,Haryana,Mahendragarh,220,341,561
2021-01-01,Haryana,Rewari,226,357,583
2021-01-01,Haryana,Gurugram,405,843,1248
2021-01-01,Haryana,Nuh,162,294,456
2021-01-01,Haryana,Faridabad,416,700,1116
2021-01-01,Haryana,Palwal ,218,331,549
2021-01-01,Haryana,Charkhi Dadri,111,156,267
2021-02-01,Haryana,Panchkula,150,248,398
2021-02-01,Haryana,Ambala,323,434,757
2021-02-01,Haryana,Yamunanagar,265,412,677
2021-02-01,Haryana,Kurukshetra,223,314,537
2021-02-01,Haryana,Kaithal,259,354,613
2021-02-01,Haryana,Karnal,294,578,872
2021-02-01,Haryana,Panipat,230,415,645
2021-02-01,Haryana,Sonipat,323,527,850
2021-02-01,Haryana,Jind,249,421,670
2021-02-01,Haryana,Fatehabad,178,298,476
2021-02-01,Haryana,Sirsa,246,397,643
2021-02-01,Haryana,Hisar,411,730,1141
2021-02-01,Haryana,Bhiwani,192,326,518
2021-02-01,Haryana,Rohtak,294,610,904
2021-02-01,Haryana,Jhajjar,190,304,494
2021-02-01,Haryana,Mahendragarh,154,229,383
2021-02-01,Haryana,Rewari,152,281,433
2021-02-01,Haryana,Gurugram,317,668,985
2021-02-01,Haryana,Nuh,132,278,410
2021-02-01,Haryana,Faridabad,346,573,919
2021-02-01,Haryana,Palwal ,154,268,422
2021-02-01,Haryana,Charkhi Dadri,78,125,203
2021-03-01,Haryana,Panchkula,182,269,451
2021-03-01,Haryana,Ambala,376,472,848
2021-03-01,Haryana,Yamunanagar,297,383,680
2021-03-01,Haryana,Kurukshetra,210,359,569
2021-03-01,Haryana,Kaithal,252,408,660
2021-03-01,Haryana,Karnal,355,596,951
2021-03-01,Haryana,Panipat,239,465,704
2021-03-01,Haryana,Sonipat,276,539,815
2021-03-01,Haryana,Jind,259,495,754
2021-03-01,Haryana,Fatehabad,191,289,480
2021-03-01,Haryana,Sirsa,273,403,676
2021-03-01,Haryana,Hisar,461,861,1322
2021-03-01,Haryana,Bhiwani,228,352,580
2021-03-01,Haryana,Rohtak,286,592,878
2021-03-01,Haryana,Jhajjar,194,324,518
2021-03-01,Haryana,Mahendragarh,174,265,439
2021-03-01,Haryana,Rewari,183,341,524
2021-03-01,Haryana,Gurugram,367,659,1026
2021-03-01,Haryana,Nuh,136,291,427
2021-03-01,Haryana,Faridabad,347,576,923
2021-03-01,Haryana,Palwal ,177,280,457
2021-03-01,Haryana,Charkhi Dadri,80,146,226
2021-04-01,Haryana,Panchkula,284,437,721
2021-04-01,Haryana,Ambala,533,711,1244
2021-04-01,Haryana,Yamunanagar,461,687,1148
2021-04-01,Haryana,Kurukshetra,361,517,878
2021-04-01,Haryana,Kaithal,388,554,942
2021-04-01,Haryana,Karnal,603,852,1455
2021-04-01,Haryana,Panipat,520,817,1337
2021-04-01,Haryana,Sonipat,742,1122,1864
2021-04-01,Haryana,Jind,490,743,1233
2021-04-01,Haryana,Fatehabad,351,436,787
2021-04-01,Haryana,Sirsa,493,681,1174
2021-04-01,Haryana,Hisar,896,1418,2314
2021-04-01,Haryana,Bhiwani,389,548,937
2021-04-01,Haryana,Rohtak,603,1119,1722
2021-04-01,Haryana,Jhajjar,572,834,1406
2021-04-01,Haryana,Mahendragarh,274,377,651
2021-04-01,Haryana,Rewari,389,541,930
2021-04-01,Haryana,Gurugram,953,1736,2689
2021-04-01,Haryana,Nuh,270,428,698
2021-04-01,Haryana,Faridabad,1113,1769,2882
2021-04-01,Haryana,Palwal ,339,521,860
2021-04-01,Haryana,Charkhi Dadri,174,230,404
2021-05-01,Haryana,Panchkula,466,677,1143
2021-05-01,Haryana,Ambala,818,1052,1870
2021-05-01,Haryana,Yamunanagar,743,968,1711
2021-05-01,Haryana,Kurukshetra,536,702,1238
2021-05-01,Haryana,Kaithal,585,801,1386
2021-05-01,Haryana,Karnal,899,1284,2183
2021-05-01,Haryana,Panipat,776,1170,1946
2021-05-01,Haryana,Sonipat,1117,1605,2722
2021-05-01,Haryana,Jind,934,1228,2162
2021-05-01,Haryana,Fatehabad,734,872,1606
2021-05-01,Haryana,Sirsa,1035,1283,2318
2021-05-01,Haryana,Hisar,1897,2505,4402
2021-05-01,Haryana,Bhiwani,1072,1167,2239
2021-05-01,Haryana,Rohtak,1106,1629,2735
2021-05-01,Haryana,Jhajjar,1007,1339,2346
2021-05-01,Haryana,Mahendragarh,768,889,1657
2021-05-01,Haryana,Rewari,795,1168,1963
2021-05-01,Haryana,Gurugram,1308,2203,3511
2021-05-01,Haryana,Nuh,436,690,1126
2021-05-01,Haryana,Faridabad,1320,2056,3376
2021-05-01,Haryana,Palwal ,631,870,1501
2021-05-01,Haryana,Charkhi Dadri,459,508,967
