date,state,district,female,male,deaths
2018-01-01,Maharashtra,Nandurbar,301,500,801
2018-01-01,Maharashtra,Dhule,330,549,879
2018-01-01,Maharashtra,Jalgaon,370,588,958
2018-01-01,Maharashtra,Buldana,223,310,533
2018-01-01,Maharashtra,Akola,378,537,915
2018-01-01,Maharashtra,Washim,69,127,196
2018-01-01,Maharashtra,Amravati,689,1059,1748
2018-01-01,Maharashtra,Wardha,292,470,762
2018-01-01,Maharashtra,Nagpur,1308,1924,3232
2018-01-01,Maharashtra,Bhandara,247,308,555
2018-01-01,Maharashtra,Gondiya,35,61,96
2018-01-01,Maharashtra,Gadchiroli,160,213,373
2018-01-01,Maharashtra,Chandrapur,262,374,636
2018-01-01,Maharashtra,Yavatmal,195,331,526
2018-01-01,Maharashtra,Nanded,363,555,918
2018-01-01,Maharashtra,Hingoli,51,95,146
2018-01-01,Maharashtra,Parbhani,194,310,504
2018-01-01,Maharashtra,Jalna,173,325,498
2018-01-01,Maharashtra,Aurangabad,290,560,850
2018-01-01,Maharashtra,Nashik,906,1293,2199
2018-01-01,Maharashtra,Thane,988,1403,2391
2018-01-01,Maharashtra,Mumbai Suburban,2090,2501,4591
2018-01-01,Maharashtra,Mumbai,1406,1998,3404
2018-01-01,Maharashtra,Raigarh,161,284,445
2018-01-01,Maharashtra,Pune,766,1154,1920
2018-01-01,Maharashtra,Ahmednagar,495,868,1363
2018-01-01,Maharashtra,Beed,239,352,591
2018-01-01,Maharashtra,Latur,315,555,870
2018-01-01,Maharashtra,Osmanabad,135,196,331
2018-01-01,Maharashtra,Solapur,483,788,1271
2018-01-01,Maharashtra,Satara,832,1103,1935
2018-01-01,Maharashtra,Ratnagiri,167,230,397
2018-01-01,Maharashtra,Sindhudurg,264,289,553
2018-01-01,Maharashtra,Kolhapur,501,701,1202
2018-01-01,Maharashtra,Sangli,362,514,876
2018-01-01,Maharashtra,Palghar,288,461,749
2018-02-01,Maharashtra,Nandurbar,263,413,676
2018-02-01,Maharashtra,Dhule,296,487,783
2018-02-01,Maharashtra,Jalgaon,347,530,877
2018-02-01,Maharashtra,Buldana,163,275,438
2018-02-01,Maharashtra,Akola,340,502,842
2018-02-01,Maharashtra,Washim,75,129,204
2018-02-01,Maharashtra,Amravati,649,934,1583
2018-02-01,Maharashtra,Wardha,246,394,640
2018-02-01,Maharashtra,Nagpur,1149,1689,2838
2018-02-01,Maharashtra,Bhandara,178,235,413
2018-02-01,Maharashtra,Gondiya,30,40,70
2018-02-01,Maharashtra,Gadchiroli,105,139,244
2018-02-01,Maharashtra,Chandrapur,236,270,506
2018-02-01,Maharashtra,Yavatmal,218,284,502
2018-02-01,Maharashtra,Nanded,268,527,795
2018-02-01,Maharashtra,Hingoli,52,98,150
2018-02-01,Maharashtra,Parbhani,176,254,430
2018-02-01,Maharashtra,Jalna,137,285,422
2018-02-01,Maharashtra,Aurangabad,302,527,829
2018-02-01,Maharashtra,Nashik,798,1090,1888
2018-02-01,Maharashtra,Thane,827,1148,1975
2018-02-01,Maharashtra,Mumbai Suburban,1792,2122,3914
2018-02-01,Maharashtra,Mumbai,1225,1825,3050
2018-02-01,Maharashtra,Raigarh,186,207,393
2018-02-01,Maharashtra,Pune,625,997,1622
2018-02-01,Maharashtra,Ahmednagar,459,710,1169
2018-02-01,Maharashtra,Beed,191,325,516
2018-02-01,Maharashtra,Latur,324,483,807
2018-02-01,Maharashtra,Osmanabad,116,171,287
2018-02-01,Maharashtra,Solapur,480,744,1224
2018-02-01,Maharashtra,Satara,672,926,1598
2018-02-01,Maharashtra,Ratnagiri,168,193,361
2018-02-01,Maharashtra,Sindhudurg,213,228,441
2018-02-01,Maharashtra,Kolhapur,473,556,1029
2018-02-01,Maharashtra,Sangli,323,469,792
2018-02-01,Maharashtra,Palghar,268,369,637
2018-03-01,Maharashtra,Nandurbar,320,478,798
2018-03-01,Maharashtra,Dhule,301,496,797
2018-03-01,Maharashtra,Jalgaon,344,518,862
2018-03-01,Maharashtra,Buldana,178,264,442
2018-03-01,Maharashtra,Akola,339,431,770
2018-03-01,Maharashtra,Washim,103,143,246
2018-03-01,Maharashtra,Amravati,579,887,1466
2018-03-01,Maharashtra,Wardha,200,372,572
2018-03-01,Maharashtra,Nagpur,1023,1539,2562
2018-03-01,Maharashtra,Bhandara,162,235,397
2018-03-01,Maharashtra,Gondiya,27,40,67
2018-03-01,Maharashtra,Gadchiroli,113,181,294
2018-03-01,Maharashtra,Chandrapur,213,342,555
2018-03-01,Maharashtra,Yavatmal,193,286,479
2018-03-01,Maharashtra,Nanded,257,485,742
2018-03-01,Maharashtra,Hingoli,53,90,143
2018-03-01,Maharashtra,Parbhani,133,294,427
2018-03-01,Maharashtra,Jalna,131,284,415
2018-03-01,Maharashtra,Aurangabad,279,508,787
2018-03-01,Maharashtra,Nashik,787,1204,1991
2018-03-01,Maharashtra,Thane,886,1168,2054
2018-03-01,Maharashtra,Mumbai Suburban,1789,2156,3945
2018-03-01,Maharashtra,Mumbai,1363,1949,3312
2018-03-01,Maharashtra,Raigarh,139,179,318
2018-03-01,Maharashtra,Pune,618,977,1595
2018-03-01,Maharashtra,Ahmednagar,456,624,1080
2018-03-01,Maharashtra,Beed,175,319,494
2018-03-01,Maharashtra,Latur,282,440,722
2018-03-01,Maharashtra,Osmanabad,121,183,304
2018-03-01,Maharashtra,Solapur,457,723,1180
2018-03-01,Maharashtra,Satara,646,826,1472
2018-03-01,Maharashtra,Ratnagiri,183,181,364
2018-03-01,Maharashtra,Sindhudurg,201,225,426
2018-03-01,Maharashtra,Kolhapur,413,560,973
2018-03-01,Maharashtra,Sangli,322,416,738
2018-03-01,Maharashtra,Palghar,262,322,584
2018-04-01,Maharashtra,Nandurbar,262,442,704
2018-04-01,Maharashtra,Dhule,312,422,734
2018-04-01,Maharashtra,Jalgaon,306,506,812
2018-04-01,Maharashtra,Buldana,142,255,397
2018-04-01,Maharashtra,Akola,291,440,731
2018-04-01,Maharashtra,Washim,59,94,153
2018-04-01,Maharashtra,Amravati,554,889,1443
2018-04-01,Maharashtra,Wardha,215,389,604
2018-04-01,Maharashtra,Nagpur,973,1534,2507
2018-04-01,Maharashtra,Bhandara,151,236,387
2018-04-01,Maharashtra,Gondiya,24,42,66
2018-04-01,Maharashtra,Gadchiroli,117,158,275
2018-04-01,Maharashtra,Chandrapur,203,329,532
2018-04-01,Maharashtra,Yavatmal,178,327,505
2018-04-01,Maharashtra,Nanded,275,461,736
2018-04-01,Maharashtra,Hingoli,42,90,132
2018-04-01,Maharashtra,Parbhani,133,256,389
2018-04-01,Maharashtra,Jalna,122,259,381
2018-04-01,Maharashtra,Aurangabad,247,498,745
2018-04-01,Maharashtra,Nashik,733,1122,1855
2018-04-01,Maharashtra,Thane,767,1149,1916
2018-04-01,Maharashtra,Mumbai Suburban,1667,2001,3668
2018-04-01,Maharashtra,Mumbai,1196,1763,2959
2018-04-01,Maharashtra,Raigarh,160,210,370
2018-04-01,Maharashtra,Pune,546,874,1420
2018-04-01,Maharashtra,Ahmednagar,419,688,1107
2018-04-01,Maharashtra,Beed,186,333,519
2018-04-01,Maharashtra,Latur,237,434,671
2018-04-01,Maharashtra,Osmanabad,110,141,251
2018-04-01,Maharashtra,Solapur,458,668,1126
2018-04-01,Maharashtra,Satara,625,860,1485
2018-04-01,Maharashtra,Ratnagiri,131,166,297
2018-04-01,Maharashtra,Sindhudurg,153,167,320
2018-04-01,Maharashtra,Kolhapur,340,433,773
2018-04-01,Maharashtra,Sangli,221,391,612
2018-04-01,Maharashtra,Palghar,212,311,523
2018-05-01,Maharashtra,Nandurbar,245,377,622
2018-05-01,Maharashtra,Dhule,309,470,779
2018-05-01,Maharashtra,Jalgaon,394,598,992
2018-05-01,Maharashtra,Buldana,174,318,492
2018-05-01,Maharashtra,Akola,382,538,920
2018-05-01,Maharashtra,Washim,94,168,262
2018-05-01,Maharashtra,Amravati,705,1043,1748
2018-05-01,Maharashtra,Wardha,321,448,769
2018-05-01,Maharashtra,Nagpur,1108,1782,2890
2018-05-01,Maharashtra,Bhandara,178,283,461
2018-05-01,Maharashtra,Gondiya,31,47,78
2018-05-01,Maharashtra,Gadchiroli,135,189,324
2018-05-01,Maharashtra,Chandrapur,265,399,664
2018-05-01,Maharashtra,Yavatmal,318,404,722
2018-05-01,Maharashtra,Nanded,304,593,897
2018-05-01,Maharashtra,Hingoli,51,101,152
2018-05-01,Maharashtra,Parbhani,170,285,455
2018-05-01,Maharashtra,Jalna,149,330,479
2018-05-01,Maharashtra,Aurangabad,275,534,809
2018-05-01,Maharashtra,Nashik,763,1138,1901
2018-05-01,Maharashtra,Thane,873,1220,2093
2018-05-01,Maharashtra,Mumbai Suburban,1739,2067,3806
2018-05-01,Maharashtra,Mumbai,1253,1762,3015
2018-05-01,Maharashtra,Raigarh,154,244,398
2018-05-01,Maharashtra,Pune,577,954,1531
2018-05-01,Maharashtra,Ahmednagar,446,705,1151
2018-05-01,Maharashtra,Beed,160,359,519
2018-05-01,Maharashtra,Latur,294,484,778
2018-05-01,Maharashtra,Osmanabad,117,214,331
2018-05-01,Maharashtra,Solapur,484,735,1219
2018-05-01,Maharashtra,Satara,658,819,1477
2018-05-01,Maharashtra,Ratnagiri,170,186,356
2018-05-01,Maharashtra,Sindhudurg,171,204,375
2018-05-01,Maharashtra,Kolhapur,361,473,834
2018-05-01,Maharashtra,Sangli,230,392,622
2018-05-01,Maharashtra,Palghar,244,328,572
2018-06-01,Maharashtra,Nandurbar,244,351,595
2018-06-01,Maharashtra,Dhule,250,378,628
2018-06-01,Maharashtra,Jalgaon,267,423,690
2018-06-01,Maharashtra,Buldana,114,228,342
2018-06-01,Maharashtra,Akola,257,404,661
2018-06-01,Maharashtra,Washim,68,137,205
2018-06-01,Maharashtra,Amravati,531,777,1308
2018-06-01,Maharashtra,Wardha,194,318,512
2018-06-01,Maharashtra,Nagpur,907,1459,2366
2018-06-01,Maharashtra,Bhandara,134,228,362
2018-06-01,Maharashtra,Gondiya,28,33,61
2018-06-01,Maharashtra,Gadchiroli,91,162,253
2018-06-01,Maharashtra,Chandrapur,196,340,536
2018-06-01,Maharashtra,Yavatmal,175,281,456
2018-06-01,Maharashtra,Nanded,239,453,692
2018-06-01,Maharashtra,Hingoli,35,73,108
2018-06-01,Maharashtra,Parbhani,144,217,361
2018-06-01,Maharashtra,Jalna,106,288,394
2018-06-01,Maharashtra,Aurangabad,202,452,654
2018-06-01,Maharashtra,Nashik,683,1027,1710
2018-06-01,Maharashtra,Thane,848,1298,2146
2018-06-01,Maharashtra,Mumbai Suburban,1634,2091,3725
2018-06-01,Maharashtra,Mumbai,1141,1807,2948
2018-06-01,Maharashtra,Raigarh,131,206,337
2018-06-01,Maharashtra,Pune,523,867,1390
2018-06-01,Maharashtra,Ahmednagar,402,619,1021
2018-06-01,Maharashtra,Beed,166,314,480
2018-06-01,Maharashtra,Latur,198,398,596
2018-06-01,Maharashtra,Osmanabad,91,159,250
2018-06-01,Maharashtra,Solapur,338,635,973
2018-06-01,Maharashtra,Satara,545,802,1347
2018-06-01,Maharashtra,Ratnagiri,135,172,307
2018-06-01,Maharashtra,Sindhudurg,154,194,348
2018-06-01,Maharashtra,Kolhapur,303,470,773
2018-06-01,Maharashtra,Sangli,168,252,420
2018-06-01,Maharashtra,Palghar,261,310,571
2018-07-01,Maharashtra,Nandurbar,307,416,723
2018-07-01,Maharashtra,Dhule,282,407,689
2018-07-01,Maharashtra,Jalgaon,314,428,742
2018-07-01,Maharashtra,Buldana,140,238,378
2018-07-01,Maharashtra,Akola,286,454,740
2018-07-01,Maharashtra,Washim,71,139,210
2018-07-01,Maharashtra,Amravati,614,980,1594
2018-07-01,Maharashtra,Wardha,223,366,589
2018-07-01,Maharashtra,Nagpur,1053,1682,2735
2018-07-01,Maharashtra,Bhandara,157,204,361
2018-07-01,Maharashtra,Gondiya,32,39,71
2018-07-01,Maharashtra,Gadchiroli,130,191,321
2018-07-01,Maharashtra,Chandrapur,242,365,607
2018-07-01,Maharashtra,Yavatmal,204,338,542
2018-07-01,Maharashtra,Nanded,280,469,749
2018-07-01,Maharashtra,Hingoli,56,65,121
2018-07-01,Maharashtra,Parbhani,137,239,376
2018-07-01,Maharashtra,Jalna,111,283,394
2018-07-01,Maharashtra,Aurangabad,254,490,744
2018-07-01,Maharashtra,Nashik,799,1086,1885
2018-07-01,Maharashtra,Thane,1146,1789,2935
2018-07-01,Maharashtra,Mumbai Suburban,1914,2433,4347
2018-07-01,Maharashtra,Mumbai,1386,2062,3448
2018-07-01,Maharashtra,Raigarh,149,212,361
2018-07-01,Maharashtra,Pune,614,977,1591
2018-07-01,Maharashtra,Ahmednagar,437,636,1073
2018-07-01,Maharashtra,Beed,131,315,446
2018-07-01,Maharashtra,Latur,232,464,696
2018-07-01,Maharashtra,Osmanabad,99,168,267
2018-07-01,Maharashtra,Solapur,421,659,1080
2018-07-01,Maharashtra,Satara,619,859,1478
2018-07-01,Maharashtra,Ratnagiri,128,180,308
2018-07-01,Maharashtra,Sindhudurg,170,183,353
2018-07-01,Maharashtra,Kolhapur,378,516,894
2018-07-01,Maharashtra,Sangli,126,159,285
2018-07-01,Maharashtra,Palghar,248,355,603
2018-08-01,Maharashtra,Nandurbar,328,458,786
2018-08-01,Maharashtra,Dhule,261,419,680
2018-08-01,Maharashtra,Jalgaon,292,477,769
2018-08-01,Maharashtra,Buldana,162,245,407
2018-08-01,Maharashtra,Akola,319,491,810
2018-08-01,Maharashtra,Washim,95,130,225
2018-08-01,Maharashtra,Amravati,688,1026,1714
2018-08-01,Maharashtra,Wardha,246,410,656
2018-08-01,Maharashtra,Nagpur,1069,1732,2801
2018-08-01,Maharashtra,Bhandara,176,252,428
2018-08-01,Maharashtra,Gondiya,28,59,87
2018-08-01,Maharashtra,Gadchiroli,106,200,306
2018-08-01,Maharashtra,Chandrapur,308,394,702
2018-08-01,Maharashtra,Yavatmal,240,344,584
2018-08-01,Maharashtra,Nanded,333,543,876
2018-08-01,Maharashtra,Hingoli,57,113,170
2018-08-01,Maharashtra,Parbhani,143,280,423
2018-08-01,Maharashtra,Jalna,141,285,426
2018-08-01,Maharashtra,Aurangabad,265,498,763
2018-08-01,Maharashtra,Nashik,855,1194,2049
2018-08-01,Maharashtra,Thane,1232,1715,2947
2018-08-01,Maharashtra,Mumbai Suburban,1828,2253,4081
2018-08-01,Maharashtra,Mumbai,1304,1966,3270
2018-08-01,Maharashtra,Raigarh,182,225,407
2018-08-01,Maharashtra,Pune,603,997,1600
2018-08-01,Maharashtra,Ahmednagar,423,669,1092
2018-08-01,Maharashtra,Beed,152,329,481
2018-08-01,Maharashtra,Latur,292,525,817
2018-08-01,Maharashtra,Osmanabad,105,175,280
2018-08-01,Maharashtra,Solapur,477,710,1187
2018-08-01,Maharashtra,Satara,712,928,1640
2018-08-01,Maharashtra,Ratnagiri,116,170,286
2018-08-01,Maharashtra,Sindhudurg,191,197,388
2018-08-01,Maharashtra,Kolhapur,447,527,974
2018-08-01,Maharashtra,Sangli,117,163,280
2018-08-01,Maharashtra,Palghar,254,350,604
2018-09-01,Maharashtra,Nandurbar,297,466,763
2018-09-01,Maharashtra,Dhule,319,468,787
2018-09-01,Maharashtra,Jalgaon,319,492,811
2018-09-01,Maharashtra,Buldana,162,239,401
2018-09-01,Maharashtra,Akola,360,543,903
2018-09-01,Maharashtra,Washim,81,133,214
2018-09-01,Maharashtra,Amravati,630,1040,1670
2018-09-01,Maharashtra,Wardha,255,404,659
2018-09-01,Maharashtra,Nagpur,1192,1826,3018
2018-09-01,Maharashtra,Bhandara,184,293,477
2018-09-01,Maharashtra,Gondiya,37,51,88
2018-09-01,Maharashtra,Gadchiroli,148,179,327
2018-09-01,Maharashtra,Chandrapur,278,402,680
2018-09-01,Maharashtra,Yavatmal,242,356,598
2018-09-01,Maharashtra,Nanded,323,534,857
2018-09-01,Maharashtra,Hingoli,64,108,172
2018-09-01,Maharashtra,Parbhani,149,255,404
2018-09-01,Maharashtra,Jalna,158,259,417
2018-09-01,Maharashtra,Aurangabad,291,551,842
2018-09-01,Maharashtra,Nashik,949,1261,2210
2018-09-01,Maharashtra,Thane,1393,1959,3352
2018-09-01,Maharashtra,Mumbai Suburban,2085,2355,4440
2018-09-01,Maharashtra,Mumbai,1493,2068,3561
2018-09-01,Maharashtra,Raigarh,160,224,384
2018-09-01,Maharashtra,Pune,630,1035,1665
2018-09-01,Maharashtra,Ahmednagar,450,715,1165
2018-09-01,Maharashtra,Beed,175,335,510
2018-09-01,Maharashtra,Latur,299,504,803
2018-09-01,Maharashtra,Osmanabad,111,201,312
2018-09-01,Maharashtra,Solapur,480,745,1225
2018-09-01,Maharashtra,Satara,773,977,1750
2018-09-01,Maharashtra,Ratnagiri,157,205,362
2018-09-01,Maharashtra,Sindhudurg,193,219,412
2018-09-01,Maharashtra,Kolhapur,417,522,939
2018-09-01,Maharashtra,Sangli,130,202,332
2018-09-01,Maharashtra,Palghar,282,370,652
2018-10-01,Maharashtra,Nandurbar,276,453,729
2018-10-01,Maharashtra,Dhule,304,470,774
2018-10-01,Maharashtra,Jalgaon,346,544,890
2018-10-01,Maharashtra,Buldana,169,294,463
2018-10-01,Maharashtra,Akola,320,572,892
2018-10-01,Maharashtra,Washim,92,137,229
2018-10-01,Maharashtra,Amravati,615,1046,1661
2018-10-01,Maharashtra,Wardha,260,423,683
2018-10-01,Maharashtra,Nagpur,1260,1908,3168
2018-10-01,Maharashtra,Bhandara,145,204,349
2018-10-01,Maharashtra,Gondiya,35,42,77
2018-10-01,Maharashtra,Gadchiroli,116,192,308
2018-10-01,Maharashtra,Chandrapur,278,391,669
2018-10-01,Maharashtra,Yavatmal,240,368,608
2018-10-01,Maharashtra,Nanded,275,535,810
2018-10-01,Maharashtra,Hingoli,57,93,150
2018-10-01,Maharashtra,Parbhani,149,282,431
2018-10-01,Maharashtra,Jalna,146,337,483
2018-10-01,Maharashtra,Aurangabad,293,514,807
2018-10-01,Maharashtra,Nashik,904,1281,2185
2018-10-01,Maharashtra,Thane,1483,1887,3370
2018-10-01,Maharashtra,Mumbai Suburban,2044,2394,4438
2018-10-01,Maharashtra,Mumbai,1412,2121,3533
2018-10-01,Maharashtra,Raigarh,150,243,393
2018-10-01,Maharashtra,Pune,595,1009,1604
2018-10-01,Maharashtra,Ahmednagar,468,715,1183
2018-10-01,Maharashtra,Beed,154,345,499
2018-10-01,Maharashtra,Latur,279,511,790
2018-10-01,Maharashtra,Osmanabad,109,180,289
2018-10-01,Maharashtra,Solapur,515,752,1267
2018-10-01,Maharashtra,Satara,642,944,1586
2018-10-01,Maharashtra,Ratnagiri,150,187,337
2018-10-01,Maharashtra,Sindhudurg,203,222,425
2018-10-01,Maharashtra,Kolhapur,391,469,860
2018-10-01,Maharashtra,Sangli,162,215,377
2018-10-01,Maharashtra,Palghar,294,331,625
2018-11-01,Maharashtra,Nandurbar,263,413,676
2018-11-01,Maharashtra,Dhule,274,444,718
2018-11-01,Maharashtra,Jalgaon,307,481,788
2018-11-01,Maharashtra,Buldana,154,244,398
2018-11-01,Maharashtra,Akola,323,505,828
2018-11-01,Maharashtra,Washim,71,125,196
2018-11-01,Maharashtra,Amravati,542,986,1528
2018-11-01,Maharashtra,Wardha,219,378,597
2018-11-01,Maharashtra,Nagpur,1132,1794,2926
2018-11-01,Maharashtra,Bhandara,172,230,402
2018-11-01,Maharashtra,Gondiya,42,71,113
2018-11-01,Maharashtra,Gadchiroli,131,154,285
2018-11-01,Maharashtra,Chandrapur,250,388,638
2018-11-01,Maharashtra,Yavatmal,179,338,517
2018-11-01,Maharashtra,Nanded,250,493,743
2018-11-01,Maharashtra,Hingoli,45,82,127
2018-11-01,Maharashtra,Parbhani,144,243,387
2018-11-01,Maharashtra,Jalna,108,282,390
2018-11-01,Maharashtra,Aurangabad,272,537,809
2018-11-01,Maharashtra,Nashik,790,1239,2029
2018-11-01,Maharashtra,Thane,1187,1766,2953
2018-11-01,Maharashtra,Mumbai Suburban,1719,2164,3883
2018-11-01,Maharashtra,Mumbai,1258,1866,3124
2018-11-01,Maharashtra,Raigarh,127,197,324
2018-11-01,Maharashtra,Pune,557,910,1467
2018-11-01,Maharashtra,Ahmednagar,429,713,1142
2018-11-01,Maharashtra,Beed,151,329,480
2018-11-01,Maharashtra,Latur,242,471,713
2018-11-01,Maharashtra,Osmanabad,80,165,245
2018-11-01,Maharashtra,Solapur,445,714,1159
2018-11-01,Maharashtra,Satara,651,872,1523
2018-11-01,Maharashtra,Ratnagiri,133,183,316
2018-11-01,Maharashtra,Sindhudurg,189,224,413
2018-11-01,Maharashtra,Kolhapur,354,483,837
2018-11-01,Maharashtra,Sangli,157,206,363
2018-11-01,Maharashtra,Palghar,253,342,595
2018-12-01,Maharashtra,Nandurbar,278,408,686
2018-12-01,Maharashtra,Dhule,320,468,788
2018-12-01,Maharashtra,Jalgaon,322,514,836
2018-12-01,Maharashtra,Buldana,180,270,450
2018-12-01,Maharashtra,Akola,334,504,838
2018-12-01,Maharashtra,Washim,72,139,211
2018-12-01,Maharashtra,Amravati,610,1093,1703
2018-12-01,Maharashtra,Wardha,238,388,626
2018-12-01,Maharashtra,Nagpur,1227,1929,3156
2018-12-01,Maharashtra,Bhandara,212,277,489
2018-12-01,Maharashtra,Gondiya,88,137,225
2018-12-01,Maharashtra,Gadchiroli,114,219,333
2018-12-01,Maharashtra,Chandrapur,325,449,774
2018-12-01,Maharashtra,Yavatmal,175,350,525
2018-12-01,Maharashtra,Nanded,260,518,778
2018-12-01,Maharashtra,Hingoli,48,86,134
2018-12-01,Maharashtra,Parbhani,139,306,445
2018-12-01,Maharashtra,Jalna,135,281,416
2018-12-01,Maharashtra,Aurangabad,298,522,820
2018-12-01,Maharashtra,Nashik,899,1302,2201
2018-12-01,Maharashtra,Thane,1282,1962,3244
2018-12-01,Maharashtra,Mumbai Suburban,1827,2378,4205
2018-12-01,Maharashtra,Mumbai,1396,1961,3357
2018-12-01,Maharashtra,Raigarh,162,200,362
2018-12-01,Maharashtra,Pune,620,998,1618
2018-12-01,Maharashtra,Ahmednagar,510,751,1261
2018-12-01,Maharashtra,Beed,170,337,507
2018-12-01,Maharashtra,Latur,266,498,764
2018-12-01,Maharashtra,Osmanabad,89,173,262
2018-12-01,Maharashtra,Solapur,435,705,1140
2018-12-01,Maharashtra,Satara,625,890,1515
2018-12-01,Maharashtra,Ratnagiri,157,205,362
2018-12-01,Maharashtra,Sindhudurg,175,257,432
2018-12-01,Maharashtra,Kolhapur,346,505,851
2018-12-01,Maharashtra,Sangli,134,232,366
2018-12-01,Maharashtra,Palghar,280,405,685
2019-01-01,Maharashtra,Nandurbar,295,432,727
2019-01-01,Maharashtra,Dhule,351,551,902
2019-01-01,Maharashtra,Jalgaon,403,637,1040
2019-01-01,Maharashtra,Buldana,178,261,439
2019-01-01,Maharashtra,Akola,359,562,921
2019-01-01,Maharashtra,Washim,76,127,203
2019-01-01,Maharashtra,Amravati,655,1074,1729
2019-01-01,Maharashtra,Wardha,298,411,709
2019-01-01,Maharashtra,Nagpur,1412,2040,3452
2019-01-01,Maharashtra,Bhandara,218,283,501
2019-01-01,Maharashtra,Gondiya,125,153,278
2019-01-01,Maharashtra,Gadchiroli,158,181,339
2019-01-01,Maharashtra,Chandrapur,334,444,778
2019-01-01,Maharashtra,Yavatmal,207,336,543
2019-01-01,Maharashtra,Nanded,375,619,994
2019-01-01,Maharashtra,Hingoli,63,103,166
2019-01-01,Maharashtra,Parbhani,179,312,491
2019-01-01,Maharashtra,Jalna,153,248,401
2019-01-01,Maharashtra,Aurangabad,325,596,921
2019-01-01,Maharashtra,Nashik,1035,1414,2449
2019-01-01,Maharashtra,Thane,1560,2129,3689
2019-01-01,Maharashtra,Mumbai Suburban,2204,2667,4871
2019-01-01,Maharashtra,Mumbai,1520,2261,3781
2019-01-01,Maharashtra,Raigarh,177,242,419
2019-01-01,Maharashtra,Pune,661,1119,1780
2019-01-01,Maharashtra,Ahmednagar,568,785,1353
2019-01-01,Maharashtra,Beed,192,309,501
2019-01-01,Maharashtra,Latur,281,508,789
2019-01-01,Maharashtra,Osmanabad,114,175,289
2019-01-01,Maharashtra,Solapur,468,814,1282
2019-01-01,Maharashtra,Satara,667,862,1529
2019-01-01,Maharashtra,Ratnagiri,167,205,372
2019-01-01,Maharashtra,Sindhudurg,187,264,451
2019-01-01,Maharashtra,Kolhapur,408,531,939
2019-01-01,Maharashtra,Sangli,152,201,353
2019-01-01,Maharashtra,Palghar,313,398,711
2019-02-01,Maharashtra,Nandurbar,225,335,560
2019-02-01,Maharashtra,Dhule,280,509,789
2019-02-01,Maharashtra,Jalgaon,341,501,842
2019-02-01,Maharashtra,Buldana,139,218,357
2019-02-01,Maharashtra,Akola,272,430,702
2019-02-01,Maharashtra,Washim,69,95,164
2019-02-01,Maharashtra,Amravati,536,832,1368
2019-02-01,Maharashtra,Wardha,232,342,574
2019-02-01,Maharashtra,Nagpur,1143,1670,2813
2019-02-01,Maharashtra,Bhandara,172,195,367
2019-02-01,Maharashtra,Gondiya,85,120,205
2019-02-01,Maharashtra,Gadchiroli,91,137,228
2019-02-01,Maharashtra,Chandrapur,233,363,596
2019-02-01,Maharashtra,Yavatmal,192,295,487
2019-02-01,Maharashtra,Nanded,310,537,847
2019-02-01,Maharashtra,Hingoli,41,69,110
2019-02-01,Maharashtra,Parbhani,149,257,406
2019-02-01,Maharashtra,Jalna,125,255,380
2019-02-01,Maharashtra,Aurangabad,280,485,765
2019-02-01,Maharashtra,Nashik,874,1251,2125
2019-02-01,Maharashtra,Thane,1352,1844,3196
2019-02-01,Maharashtra,Mumbai Suburban,1787,2269,4056
2019-02-01,Maharashtra,Mumbai,1348,1945,3293
2019-02-01,Maharashtra,Raigarh,163,226,389
2019-02-01,Maharashtra,Pune,575,908,1483
2019-02-01,Maharashtra,Ahmednagar,448,644,1092
2019-02-01,Maharashtra,Beed,140,271,411
2019-02-01,Maharashtra,Latur,231,435,666
2019-02-01,Maharashtra,Osmanabad,95,143,238
2019-02-01,Maharashtra,Solapur,419,654,1073
2019-02-01,Maharashtra,Satara,537,631,1168
2019-02-01,Maharashtra,Ratnagiri,125,195,320
2019-02-01,Maharashtra,Sindhudurg,190,195,385
2019-02-01,Maharashtra,Kolhapur,299,428,727
2019-02-01,Maharashtra,Sangli,116,144,260
2019-02-01,Maharashtra,Palghar,299,398,697
2019-03-01,Maharashtra,Nandurbar,252,406,658
2019-03-01,Maharashtra,Dhule,285,461,746
2019-03-01,Maharashtra,Jalgaon,336,541,877
2019-03-01,Maharashtra,Buldana,118,268,386
2019-03-01,Maharashtra,Akola,308,418,726
2019-03-01,Maharashtra,Washim,70,127,197
2019-03-01,Maharashtra,Amravati,477,767,1244
2019-03-01,Maharashtra,Wardha,194,358,552
2019-03-01,Maharashtra,Nagpur,1102,1595,2697
2019-03-01,Maharashtra,Bhandara,162,200,362
2019-03-01,Maharashtra,Gondiya,67,131,198
2019-03-01,Maharashtra,Gadchiroli,85,147,232
2019-03-01,Maharashtra,Chandrapur,232,303,535
2019-03-01,Maharashtra,Yavatmal,176,291,467
2019-03-01,Maharashtra,Nanded,285,456,741
2019-03-01,Maharashtra,Hingoli,51,97,148
2019-03-01,Maharashtra,Parbhani,153,247,400
2019-03-01,Maharashtra,Jalna,123,236,359
2019-03-01,Maharashtra,Aurangabad,274,579,853
2019-03-01,Maharashtra,Nashik,832,1270,2102
2019-03-01,Maharashtra,Thane,1340,1940,3280
2019-03-01,Maharashtra,Mumbai Suburban,1799,2226,4025
2019-03-01,Maharashtra,Mumbai,1317,2018,3335
2019-03-01,Maharashtra,Raigarh,151,198,349
2019-03-01,Maharashtra,Pune,1687,2484,4171
2019-03-01,Maharashtra,Ahmednagar,460,676,1136
2019-03-01,Maharashtra,Beed,146,328,474
2019-03-01,Maharashtra,Latur,270,446,716
2019-03-01,Maharashtra,Osmanabad,85,126,211
2019-03-01,Maharashtra,Solapur,437,722,1159
2019-03-01,Maharashtra,Satara,548,671,1219
2019-03-01,Maharashtra,Ratnagiri,128,179,307
2019-03-01,Maharashtra,Sindhudurg,183,207,390
2019-03-01,Maharashtra,Kolhapur,316,439,755
2019-03-01,Maharashtra,Sangli,94,132,226
2019-03-01,Maharashtra,Palghar,307,411,718
2019-04-01,Maharashtra,Nandurbar,253,403,656
2019-04-01,Maharashtra,Dhule,294,458,752
2019-04-01,Maharashtra,Jalgaon,344,561,905
2019-04-01,Maharashtra,Buldana,123,229,352
2019-04-01,Maharashtra,Akola,299,490,789
2019-04-01,Maharashtra,Washim,64,107,171
2019-04-01,Maharashtra,Amravati,503,817,1320
2019-04-01,Maharashtra,Wardha,194,346,540
2019-04-01,Maharashtra,Nagpur,983,1504,2487
2019-04-01,Maharashtra,Bhandara,143,188,331
2019-04-01,Maharashtra,Gondiya,66,149,215
2019-04-01,Maharashtra,Gadchiroli,101,156,257
2019-04-01,Maharashtra,Chandrapur,281,339,620
2019-04-01,Maharashtra,Yavatmal,187,284,471
2019-04-01,Maharashtra,Nanded,293,550,843
2019-04-01,Maharashtra,Hingoli,60,105,165
2019-04-01,Maharashtra,Parbhani,162,275,437
2019-04-01,Maharashtra,Jalna,127,240,367
2019-04-01,Maharashtra,Aurangabad,318,566,884
2019-04-01,Maharashtra,Nashik,819,1146,1965
2019-04-01,Maharashtra,Thane,1280,1736,3016
2019-04-01,Maharashtra,Mumbai Suburban,1701,2073,3774
2019-04-01,Maharashtra,Mumbai,1247,1669,2916
2019-04-01,Maharashtra,Raigarh,139,189,328
2019-04-01,Maharashtra,Pune,1614,2501,4115
2019-04-01,Maharashtra,Ahmednagar,457,716,1173
2019-04-01,Maharashtra,Beed,151,293,444
2019-04-01,Maharashtra,Latur,295,480,775
2019-04-01,Maharashtra,Osmanabad,106,155,261
2019-04-01,Maharashtra,Solapur,432,769,1201
2019-04-01,Maharashtra,Satara,471,675,1146
2019-04-01,Maharashtra,Ratnagiri,126,156,282
2019-04-01,Maharashtra,Sindhudurg,150,171,321
2019-04-01,Maharashtra,Kolhapur,294,384,678
2019-04-01,Maharashtra,Sangli,101,150,251
2019-04-01,Maharashtra,Palghar,248,409,657
2019-05-01,Maharashtra,Nandurbar,225,384,609
2019-05-01,Maharashtra,Dhule,293,486,779
2019-05-01,Maharashtra,Jalgaon,375,567,942
2019-05-01,Maharashtra,Buldana,183,252,435
2019-05-01,Maharashtra,Akola,308,533,841
2019-05-01,Maharashtra,Washim,82,124,206
2019-05-01,Maharashtra,Amravati,579,965,1544
2019-05-01,Maharashtra,Wardha,296,419,715
2019-05-01,Maharashtra,Nagpur,1146,1834,2980
2019-05-01,Maharashtra,Bhandara,210,254,464
2019-05-01,Maharashtra,Gondiya,123,170,293
2019-05-01,Maharashtra,Gadchiroli,151,221,372
2019-05-01,Maharashtra,Chandrapur,323,468,791
2019-05-01,Maharashtra,Yavatmal,198,360,558
2019-05-01,Maharashtra,Nanded,346,660,1006
2019-05-01,Maharashtra,Hingoli,56,119,175
2019-05-01,Maharashtra,Parbhani,194,269,463
2019-05-01,Maharashtra,Jalna,123,264,387
2019-05-01,Maharashtra,Aurangabad,256,518,774
2019-05-01,Maharashtra,Nashik,735,1146,1881
2019-05-01,Maharashtra,Thane,1216,1717,2933
2019-05-01,Maharashtra,Mumbai Suburban,1737,2066,3803
2019-05-01,Maharashtra,Mumbai,1300,1740,3040
2019-05-01,Maharashtra,Raigarh,135,210,345
2019-05-01,Maharashtra,Pune,1546,2377,3923
2019-05-01,Maharashtra,Ahmednagar,468,678,1146
2019-05-01,Maharashtra,Beed,185,344,529
2019-05-01,Maharashtra,Latur,360,555,915
2019-05-01,Maharashtra,Osmanabad,126,158,284
2019-05-01,Maharashtra,Solapur,553,807,1360
2019-05-01,Maharashtra,Satara,516,761,1277
2019-05-01,Maharashtra,Ratnagiri,139,191,330
2019-05-01,Maharashtra,Sindhudurg,139,171,310
2019-05-01,Maharashtra,Kolhapur,317,358,675
2019-05-01,Maharashtra,Sangli,83,155,238
2019-05-01,Maharashtra,Palghar,255,379,634
2019-06-01,Maharashtra,Nandurbar,213,332,545
2019-06-01,Maharashtra,Dhule,320,461,781
2019-06-01,Maharashtra,Jalgaon,357,542,899
2019-06-01,Maharashtra,Buldana,204,288,492
2019-06-01,Maharashtra,Akola,335,510,845
2019-06-01,Maharashtra,Washim,74,140,214
2019-06-01,Maharashtra,Amravati,620,996,1616
2019-06-01,Maharashtra,Wardha,264,432,696
2019-06-01,Maharashtra,Nagpur,1054,1759,2813
2019-06-01,Maharashtra,Bhandara,213,276,489
2019-06-01,Maharashtra,Gondiya,100,170,270
2019-06-01,Maharashtra,Gadchiroli,154,221,375
2019-06-01,Maharashtra,Chandrapur,288,429,717
2019-06-01,Maharashtra,Yavatmal,201,283,484
2019-06-01,Maharashtra,Nanded,293,578,871
2019-06-01,Maharashtra,Hingoli,56,93,149
2019-06-01,Maharashtra,Parbhani,148,258,406
2019-06-01,Maharashtra,Jalna,125,227,352
2019-06-01,Maharashtra,Aurangabad,230,486,716
2019-06-01,Maharashtra,Nashik,650,1077,1727
2019-06-01,Maharashtra,Thane,1217,1713,2930
2019-06-01,Maharashtra,Mumbai Suburban,1782,2047,3829
2019-06-01,Maharashtra,Mumbai,1157,1785,2942
2019-06-01,Maharashtra,Raigarh,137,202,339
2019-06-01,Maharashtra,Pune,1313,2142,3455
2019-06-01,Maharashtra,Ahmednagar,393,642,1035
2019-06-01,Maharashtra,Beed,159,305,464
2019-06-01,Maharashtra,Latur,220,444,664
2019-06-01,Maharashtra,Osmanabad,74,133,207
2019-06-01,Maharashtra,Solapur,412,673,1085
2019-06-01,Maharashtra,Satara,411,602,1013
2019-06-01,Maharashtra,Ratnagiri,101,148,249
2019-06-01,Maharashtra,Sindhudurg,131,163,294
2019-06-01,Maharashtra,Kolhapur,244,387,631
2019-06-01,Maharashtra,Sangli,81,111,192
2019-06-01,Maharashtra,Palghar,285,334,619
2019-07-01,Maharashtra,Nandurbar,280,357,637
2019-07-01,Maharashtra,Dhule,304,446,750
2019-07-01,Maharashtra,Jalgaon,279,517,796
2019-07-01,Maharashtra,Buldana,160,260,420
2019-07-01,Maharashtra,Akola,269,460,729
2019-07-01,Maharashtra,Washim,70,127,197
2019-07-01,Maharashtra,Amravati,506,845,1351
2019-07-01,Maharashtra,Wardha,202,323,525
2019-07-01,Maharashtra,Nagpur,932,1568,2500
2019-07-01,Maharashtra,Bhandara,123,172,295
2019-07-01,Maharashtra,Gondiya,77,121,198
2019-07-01,Maharashtra,Gadchiroli,122,198,320
2019-07-01,Maharashtra,Chandrapur,207,351,558
2019-07-01,Maharashtra,Yavatmal,148,257,405
2019-07-01,Maharashtra,Nanded,267,534,801
2019-07-01,Maharashtra,Hingoli,42,97,139
2019-07-01,Maharashtra,Parbhani,161,255,416
2019-07-01,Maharashtra,Jalna,134,238,372
2019-07-01,Maharashtra,Aurangabad,237,503,740
2019-07-01,Maharashtra,Nashik,760,1131,1891
2019-07-01,Maharashtra,Thane,1489,2154,3643
2019-07-01,Maharashtra,Mumbai Suburban,2094,2652,4746
2019-07-01,Maharashtra,Mumbai,1451,2149,3600
2019-07-01,Maharashtra,Raigarh,149,228,377
2019-07-01,Maharashtra,Pune,1571,2441,4012
2019-07-01,Maharashtra,Ahmednagar,429,690,1119
2019-07-01,Maharashtra,Beed,178,320,498
2019-07-01,Maharashtra,Latur,233,392,625
2019-07-01,Maharashtra,Osmanabad,98,176,274
2019-07-01,Maharashtra,Solapur,413,728,1141
2019-07-01,Maharashtra,Satara,484,634,1118
2019-07-01,Maharashtra,Ratnagiri,107,173,280
2019-07-01,Maharashtra,Sindhudurg,166,199,365
2019-07-01,Maharashtra,Kolhapur,305,426,731
2019-07-01,Maharashtra,Sangli,81,118,199
2019-07-01,Maharashtra,Palghar,313,427,740
2019-08-01,Maharashtra,Nandurbar,337,497,834
2019-08-01,Maharashtra,Dhule,378,577,955
2019-08-01,Maharashtra,Jalgaon,406,608,1014
2019-08-01,Maharashtra,Buldana,192,269,461
2019-08-01,Maharashtra,Akola,375,552,927
2019-08-01,Maharashtra,Washim,104,159,263
2019-08-01,Maharashtra,Amravati,662,1142,1804
2019-08-01,Maharashtra,Wardha,250,476,726
2019-08-01,Maharashtra,Nagpur,1153,1828,2981
2019-08-01,Maharashtra,Bhandara,139,213,352
2019-08-01,Maharashtra,Gondiya,86,176,262
2019-08-01,Maharashtra,Gadchiroli,141,193,334
2019-08-01,Maharashtra,Chandrapur,295,444,739
2019-08-01,Maharashtra,Yavatmal,224,332,556
2019-08-01,Maharashtra,Nanded,351,600,951
2019-08-01,Maharashtra,Hingoli,57,115,172
2019-08-01,Maharashtra,Parbhani,192,304,496
2019-08-01,Maharashtra,Jalna,126,308,434
2019-08-01,Maharashtra,Aurangabad,307,607,914
2019-08-01,Maharashtra,Nashik,961,1330,2291
2019-08-01,Maharashtra,Thane,1506,2229,3735
2019-08-01,Maharashtra,Mumbai Suburban,2078,2569,4647
2019-08-01,Maharashtra,Mumbai,1427,2137,3564
2019-08-01,Maharashtra,Raigarh,156,238,394
2019-08-01,Maharashtra,Pune,1996,2906,4902
2019-08-01,Maharashtra,Ahmednagar,536,864,1400
2019-08-01,Maharashtra,Beed,177,378,555
2019-08-01,Maharashtra,Latur,271,517,788
2019-08-01,Maharashtra,Osmanabad,98,175,273
2019-08-01,Maharashtra,Solapur,494,799,1293
2019-08-01,Maharashtra,Satara,595,740,1335
2019-08-01,Maharashtra,Ratnagiri,127,159,286
2019-08-01,Maharashtra,Sindhudurg,188,191,379
2019-08-01,Maharashtra,Kolhapur,418,523,941
2019-08-01,Maharashtra,Sangli,102,144,246
2019-08-01,Maharashtra,Palghar,362,417,779
2019-09-01,Maharashtra,Nandurbar,318,411,729
2019-09-01,Maharashtra,Dhule,324,507,831
2019-09-01,Maharashtra,Jalgaon,405,539,944
2019-09-01,Maharashtra,Buldana,188,327,515
2019-09-01,Maharashtra,Akola,416,635,1051
2019-09-01,Maharashtra,Washim,98,146,244
2019-09-01,Maharashtra,Amravati,744,1219,1963
2019-09-01,Maharashtra,Wardha,277,489,766
2019-09-01,Maharashtra,Nagpur,1250,2043,3293
2019-09-01,Maharashtra,Bhandara,165,273,438
2019-09-01,Maharashtra,Gondiya,109,166,275
2019-09-01,Maharashtra,Gadchiroli,164,272,436
2019-09-01,Maharashtra,Chandrapur,317,444,761
2019-09-01,Maharashtra,Yavatmal,233,407,640
2019-09-01,Maharashtra,Nanded,345,610,955
2019-09-01,Maharashtra,Hingoli,52,90,142
2019-09-01,Maharashtra,Parbhani,190,308,498
2019-09-01,Maharashtra,Jalna,150,285,435
2019-09-01,Maharashtra,Aurangabad,332,638,970
2019-09-01,Maharashtra,Nashik,858,1280,2138
2019-09-01,Maharashtra,Thane,1336,2052,3388
2019-09-01,Maharashtra,Mumbai Suburban,1975,2413,4388
2019-09-01,Maharashtra,Mumbai,1392,2131,3523
2019-09-01,Maharashtra,Raigarh,157,203,360
2019-09-01,Maharashtra,Pune,1755,2722,4477
2019-09-01,Maharashtra,Ahmednagar,509,776,1285
2019-09-01,Maharashtra,Beed,152,361,513
2019-09-01,Maharashtra,Latur,258,471,729
2019-09-01,Maharashtra,Osmanabad,108,198,306
2019-09-01,Maharashtra,Solapur,447,711,1158
2019-09-01,Maharashtra,Satara,530,733,1263
2019-09-01,Maharashtra,Ratnagiri,150,207,357
2019-09-01,Maharashtra,Sindhudurg,204,206,410
2019-09-01,Maharashtra,Kolhapur,315,426,741
2019-09-01,Maharashtra,Sangli,98,123,221
2019-09-01,Maharashtra,Palghar,280,424,704
2019-10-01,Maharashtra,Nandurbar,264,385,649
2019-10-01,Maharashtra,Dhule,281,482,763
2019-10-01,Maharashtra,Jalgaon,348,536,884
2019-10-01,Maharashtra,Buldana,165,290,455
2019-10-01,Maharashtra,Akola,334,547,881
2019-10-01,Maharashtra,Washim,96,135,231
2019-10-01,Maharashtra,Amravati,653,1065,1718
2019-10-01,Maharashtra,Wardha,280,408,688
2019-10-01,Maharashtra,Nagpur,1169,1858,3027
2019-10-01,Maharashtra,Bhandara,133,202,335
2019-10-01,Maharashtra,Gondiya,94,167,261
2019-10-01,Maharashtra,Gadchiroli,143,179,322
2019-10-01,Maharashtra,Chandrapur,299,385,684
2019-10-01,Maharashtra,Yavatmal,227,347,574
2019-10-01,Maharashtra,Nanded,296,610,906
2019-10-01,Maharashtra,Hingoli,70,94,164
2019-10-01,Maharashtra,Parbhani,184,322,506
2019-10-01,Maharashtra,Jalna,163,313,476
2019-10-01,Maharashtra,Aurangabad,326,618,944
2019-10-01,Maharashtra,Nashik,878,1307,2185
2019-10-01,Maharashtra,Thane,1395,1893,3288
2019-10-01,Maharashtra,Mumbai Suburban,1913,2365,4278
2019-10-01,Maharashtra,Mumbai,1374,2088,3462
2019-10-01,Maharashtra,Raigarh,124,191,315
2019-10-01,Maharashtra,Pune,1770,2624,4394
2019-10-01,Maharashtra,Ahmednagar,498,756,1254
2019-10-01,Maharashtra,Beed,165,308,473
2019-10-01,Maharashtra,Latur,303,603,906
2019-10-01,Maharashtra,Osmanabad,119,191,310
2019-10-01,Maharashtra,Solapur,502,758,1260
2019-10-01,Maharashtra,Satara,470,635,1105
2019-10-01,Maharashtra,Ratnagiri,121,145,266
2019-10-01,Maharashtra,Sindhudurg,188,206,394
2019-10-01,Maharashtra,Kolhapur,363,382,745
2019-10-01,Maharashtra,Sangli,83,127,210
2019-10-01,Maharashtra,Palghar,275,440,715
2019-11-01,Maharashtra,Nandurbar,215,351,566
2019-11-01,Maharashtra,Dhule,249,438,687
2019-11-01,Maharashtra,Jalgaon,344,492,836
2019-11-01,Maharashtra,Buldana,169,266,435
2019-11-01,Maharashtra,Akola,368,541,909
2019-11-01,Maharashtra,Washim,83,125,208
2019-11-01,Maharashtra,Amravati,545,965,1510
2019-11-01,Maharashtra,Wardha,251,445,696
2019-11-01,Maharashtra,Nagpur,1147,1736,2883
2019-11-01,Maharashtra,Bhandara,130,218,348
2019-11-01,Maharashtra,Gondiya,97,163,260
2019-11-01,Maharashtra,Gadchiroli,138,221,359
2019-11-01,Maharashtra,Chandrapur,249,391,640
2019-11-01,Maharashtra,Yavatmal,217,326,543
2019-11-01,Maharashtra,Nanded,295,557,852
2019-11-01,Maharashtra,Hingoli,41,98,139
2019-11-01,Maharashtra,Parbhani,168,371,539
2019-11-01,Maharashtra,Jalna,144,259,403
2019-11-01,Maharashtra,Aurangabad,290,575,865
2019-11-01,Maharashtra,Nashik,838,1216,2054
2019-11-01,Maharashtra,Thane,1300,1900,3200
2019-11-01,Maharashtra,Mumbai Suburban,1776,2225,4001
2019-11-01,Maharashtra,Mumbai,1281,1912,3193
2019-11-01,Maharashtra,Raigarh,117,226,343
2019-11-01,Maharashtra,Pune,1713,2503,4216
2019-11-01,Maharashtra,Ahmednagar,493,719,1212
2019-11-01,Maharashtra,Beed,198,340,538
2019-11-01,Maharashtra,Latur,333,523,856
2019-11-01,Maharashtra,Osmanabad,100,174,274
2019-11-01,Maharashtra,Solapur,457,835,1292
2019-11-01,Maharashtra,Satara,458,669,1127
2019-11-01,Maharashtra,Ratnagiri,110,173,283
2019-11-01,Maharashtra,Sindhudurg,169,185,354
2019-11-01,Maharashtra,Kolhapur,336,396,732
2019-11-01,Maharashtra,Sangli,76,114,190
2019-11-01,Maharashtra,Palghar,273,375,648
2019-12-01,Maharashtra,Nandurbar,242,373,615
2019-12-01,Maharashtra,Dhule,305,515,820
2019-12-01,Maharashtra,Jalgaon,356,609,965
2019-12-01,Maharashtra,Buldana,194,343,537
2019-12-01,Maharashtra,Akola,344,575,919
2019-12-01,Maharashtra,Washim,75,146,221
2019-12-01,Maharashtra,Amravati,541,993,1534
2019-12-01,Maharashtra,Wardha,280,438,718
2019-12-01,Maharashtra,Nagpur,1178,1992,3170
2019-12-01,Maharashtra,Bhandara,174,234,408
2019-12-01,Maharashtra,Gondiya,125,179,304
2019-12-01,Maharashtra,Gadchiroli,131,181,312
2019-12-01,Maharashtra,Chandrapur,300,445,745
2019-12-01,Maharashtra,Yavatmal,183,368,551
2019-12-01,Maharashtra,Nanded,323,591,914
2019-12-01,Maharashtra,Hingoli,49,108,157
2019-12-01,Maharashtra,Parbhani,191,325,516
2019-12-01,Maharashtra,Jalna,163,327,490
2019-12-01,Maharashtra,Aurangabad,349,582,931
2019-12-01,Maharashtra,Nashik,839,1275,2114
2019-12-01,Maharashtra,Thane,1432,1886,3318
2019-12-01,Maharashtra,Mumbai Suburban,1869,2242,4111
2019-12-01,Maharashtra,Mumbai,1311,1943,3254
2019-12-01,Maharashtra,Raigarh,119,199,318
2019-12-01,Maharashtra,Pune,1719,2515,4234
2019-12-01,Maharashtra,Ahmednagar,505,762,1267
2019-12-01,Maharashtra,Beed,171,360,531
2019-12-01,Maharashtra,Latur,273,546,819
2019-12-01,Maharashtra,Osmanabad,112,185,297
2019-12-01,Maharashtra,Solapur,456,860,1316
2019-12-01,Maharashtra,Satara,448,699,1147
2019-12-01,Maharashtra,Ratnagiri,119,187,306
2019-12-01,Maharashtra,Sindhudurg,210,213,423
2019-12-01,Maharashtra,Kolhapur,319,463,782
2019-12-01,Maharashtra,Sangli,105,131,236
2019-12-01,Maharashtra,Palghar,326,436,762
2020-01-01,Maharashtra,Nandurbar,248,441,689
2020-01-01,Maharashtra,Dhule,339,563,902
2020-01-01,Maharashtra,Jalgaon,386,576,962
2020-01-01,Maharashtra,Buldana,194,289,483
2020-01-01,Maharashtra,Akola,359,546,905
2020-01-01,Maharashtra,Washim,107,141,248
2020-01-01,Maharashtra,Amravati,583,980,1563
2020-01-01,Maharashtra,Wardha,262,422,684
2020-01-01,Maharashtra,Nagpur,1404,2024,3428
2020-01-01,Maharashtra,Bhandara,189,261,450
2020-01-01,Maharashtra,Gondiya,115,149,264
2020-01-01,Maharashtra,Gadchiroli,157,210,367
2020-01-01,Maharashtra,Chandrapur,276,357,633
2020-01-01,Maharashtra,Yavatmal,201,347,548
2020-01-01,Maharashtra,Nanded,365,571,936
2020-01-01,Maharashtra,Hingoli,61,101,162
2020-01-01,Maharashtra,Parbhani,179,342,521
2020-01-01,Maharashtra,Jalna,130,280,410
2020-01-01,Maharashtra,Aurangabad,331,634,965
2020-01-01,Maharashtra,Nashik,943,1414,2357
2020-01-01,Maharashtra,Thane,1418,2146,3564
2020-01-01,Maharashtra,Mumbai Suburban,1996,2521,4517
2020-01-01,Maharashtra,Mumbai,1451,2138,3589
2020-01-01,Maharashtra,Raigarh,181,249,430
2020-01-01,Maharashtra,Pune,1815,2688,4503
2020-01-01,Maharashtra,Ahmednagar,568,889,1457
2020-01-01,Maharashtra,Beed,187,348,535
2020-01-01,Maharashtra,Latur,250,530,780
2020-01-01,Maharashtra,Osmanabad,119,181,300
2020-01-01,Maharashtra,Solapur,449,796,1245
2020-01-01,Maharashtra,Satara,557,792,1349
2020-01-01,Maharashtra,Ratnagiri,138,167,305
2020-01-01,Maharashtra,Sindhudurg,230,223,453
2020-01-01,Maharashtra,Kolhapur,311,489,800
2020-01-01,Maharashtra,Sangli,110,154,264
2020-01-01,Maharashtra,Palghar,349,531,880
2020-02-01,Maharashtra,Nandurbar,215,359,574
2020-02-01,Maharashtra,Dhule,305,462,767
2020-02-01,Maharashtra,Jalgaon,320,531,851
2020-02-01,Maharashtra,Buldana,146,229,375
2020-02-01,Maharashtra,Akola,262,466,728
2020-02-01,Maharashtra,Washim,75,115,190
2020-02-01,Maharashtra,Amravati,497,878,1375
2020-02-01,Maharashtra,Wardha,197,350,547
2020-02-01,Maharashtra,Nagpur,1158,1713,2871
2020-02-01,Maharashtra,Bhandara,138,197,335
2020-02-01,Maharashtra,Gondiya,93,126,219
2020-02-01,Maharashtra,Gadchiroli,122,198,320
2020-02-01,Maharashtra,Chandrapur,206,314,520
2020-02-01,Maharashtra,Yavatmal,182,325,507
2020-02-01,Maharashtra,Nanded,292,516,808
2020-02-01,Maharashtra,Hingoli,54,105,159
2020-02-01,Maharashtra,Parbhani,159,280,439
2020-02-01,Maharashtra,Jalna,97,280,377
2020-02-01,Maharashtra,Aurangabad,391,754,1145
2020-02-01,Maharashtra,Nashik,785,1147,1932
2020-02-01,Maharashtra,Thane,1315,1978,3293
2020-02-01,Maharashtra,Mumbai Suburban,1898,2266,4164
2020-02-01,Maharashtra,Mumbai,1338,1966,3304
2020-02-01,Maharashtra,Raigarh,176,218,394
2020-02-01,Maharashtra,Pune,1545,2321,3866
2020-02-01,Maharashtra,Ahmednagar,470,704,1174
2020-02-01,Maharashtra,Beed,137,318,455
2020-02-01,Maharashtra,Latur,220,430,650
2020-02-01,Maharashtra,Osmanabad,88,157,245
2020-02-01,Maharashtra,Solapur,410,673,1083
2020-02-01,Maharashtra,Satara,473,649,1122
2020-02-01,Maharashtra,Ratnagiri,115,177,292
2020-02-01,Maharashtra,Sindhudurg,211,243,454
2020-02-01,Maharashtra,Kolhapur,297,397,694
2020-02-01,Maharashtra,Sangli,79,124,203
2020-02-01,Maharashtra,Palghar,321,460,781
2020-03-01,Maharashtra,Nandurbar,215,369,584
2020-03-01,Maharashtra,Dhule,303,422,725
2020-03-01,Maharashtra,Jalgaon,294,496,790
2020-03-01,Maharashtra,Buldana,128,216,344
2020-03-01,Maharashtra,Akola,241,422,663
2020-03-01,Maharashtra,Washim,58,109,167
2020-03-01,Maharashtra,Amravati,512,839,1351
2020-03-01,Maharashtra,Wardha,177,330,507
2020-03-01,Maharashtra,Nagpur,912,1408,2320
2020-03-01,Maharashtra,Bhandara,116,154,270
2020-03-01,Maharashtra,Gondiya,74,119,193
2020-03-01,Maharashtra,Gadchiroli,119,182,301
2020-03-01,Maharashtra,Chandrapur,184,296,480
2020-03-01,Maharashtra,Yavatmal,187,253,440
2020-03-01,Maharashtra,Nanded,303,520,823
2020-03-01,Maharashtra,Hingoli,54,94,148
2020-03-01,Maharashtra,Parbhani,140,259,399
2020-03-01,Maharashtra,Jalna,122,267,389
2020-03-01,Maharashtra,Aurangabad,385,719,1104
2020-03-01,Maharashtra,Nashik,735,1097,1832
2020-03-01,Maharashtra,Thane,1261,1889,3150
2020-03-01,Maharashtra,Mumbai Suburban,1778,2310,4088
2020-03-01,Maharashtra,Mumbai,1263,1794,3057
2020-03-01,Maharashtra,Raigarh,138,203,341
2020-03-01,Maharashtra,Pune,1524,2231,3755
2020-03-01,Maharashtra,Ahmednagar,474,733,1207
2020-03-01,Maharashtra,Beed,120,333,453
2020-03-01,Maharashtra,Latur,236,426,662
2020-03-01,Maharashtra,Osmanabad,78,166,244
2020-03-01,Maharashtra,Solapur,387,640,1027
2020-03-01,Maharashtra,Satara,430,597,1027
2020-03-01,Maharashtra,Ratnagiri,128,174,302
2020-03-01,Maharashtra,Sindhudurg,184,218,402
2020-03-01,Maharashtra,Kolhapur,269,337,606
2020-03-01,Maharashtra,Sangli,76,112,188
2020-03-01,Maharashtra,Palghar,314,424,738
2020-04-01,Maharashtra,Nandurbar,216,338,554
2020-04-01,Maharashtra,Dhule,254,398,652
2020-04-01,Maharashtra,Jalgaon,359,436,795
2020-04-01,Maharashtra,Buldana,111,202,313
2020-04-01,Maharashtra,Akola,253,334,587
2020-04-01,Maharashtra,Washim,59,88,147
2020-04-01,Maharashtra,Amravati,502,731,1233
2020-04-01,Maharashtra,Wardha,165,270,435
2020-04-01,Maharashtra,Nagpur,780,1101,1881
2020-04-01,Maharashtra,Bhandara,106,160,266
2020-04-01,Maharashtra,Gondiya,77,94,171
2020-04-01,Maharashtra,Gadchiroli,125,146,271
2020-04-01,Maharashtra,Chandrapur,210,275,485
2020-04-01,Maharashtra,Yavatmal,166,220,386
2020-04-01,Maharashtra,Nanded,306,463,769
2020-04-01,Maharashtra,Hingoli,52,88,140
2020-04-01,Maharashtra,Parbhani,192,256,448
2020-04-01,Maharashtra,Jalna,122,195,317
2020-04-01,Maharashtra,Aurangabad,294,495,789
2020-04-01,Maharashtra,Nashik,995,1202,2197
2020-04-01,Maharashtra,Thane,1422,1848,3270
2020-04-01,Maharashtra,Mumbai Suburban,2282,2338,4620
2020-04-01,Maharashtra,Mumbai,1305,1858,3163
2020-04-01,Maharashtra,Raigarh,166,193,359
2020-04-01,Maharashtra,Pune,1663,2057,3720
2020-04-01,Maharashtra,Ahmednagar,454,621,1075
2020-04-01,Maharashtra,Beed,159,279,438
2020-04-01,Maharashtra,Latur,243,404,647
2020-04-01,Maharashtra,Osmanabad,99,149,248
2020-04-01,Maharashtra,Solapur,388,562,950
2020-04-01,Maharashtra,Satara,378,514,892
2020-04-01,Maharashtra,Ratnagiri,117,165,282
2020-04-01,Maharashtra,Sindhudurg,166,193,359
2020-04-01,Maharashtra,Kolhapur,263,322,585
2020-04-01,Maharashtra,Sangli,74,80,154
2020-04-01,Maharashtra,Palghar,306,424,730
2020-05-01,Maharashtra,Nandurbar,235,355,590
2020-05-01,Maharashtra,Dhule,353,556,909
2020-05-01,Maharashtra,Jalgaon,573,860,1433
2020-05-01,Maharashtra,Buldana,176,250,426
2020-05-01,Maharashtra,Akola,365,565,930
2020-05-01,Maharashtra,Washim,76,124,200
2020-05-01,Maharashtra,Amravati,506,869,1375
2020-05-01,Maharashtra,Wardha,229,361,590
2020-05-01,Maharashtra,Nagpur,1054,1332,2386
2020-05-01,Maharashtra,Bhandara,140,209,349
2020-05-01,Maharashtra,Gondiya,92,120,212
2020-05-01,Maharashtra,Gadchiroli,160,193,353
2020-05-01,Maharashtra,Chandrapur,281,377,658
2020-05-01,Maharashtra,Yavatmal,160,310,470
2020-05-01,Maharashtra,Nanded,352,633,985
2020-05-01,Maharashtra,Hingoli,70,114,184
2020-05-01,Maharashtra,Parbhani,201,333,534
2020-05-01,Maharashtra,Jalna,125,273,398
2020-05-01,Maharashtra,Aurangabad,385,688,1073
2020-05-01,Maharashtra,Nashik,1020,1364,2384
2020-05-01,Maharashtra,Thane,1989,2628,4617
2020-05-01,Maharashtra,Mumbai Suburban,4108,5266,9374
2020-05-01,Maharashtra,Mumbai,2224,3259,5483
2020-05-01,Maharashtra,Raigarh,184,232,416
2020-05-01,Maharashtra,Pune,1785,2423,4208
2020-05-01,Maharashtra,Ahmednagar,557,742,1299
2020-05-01,Maharashtra,Beed,193,328,521
2020-05-01,Maharashtra,Latur,318,492,810
2020-05-01,Maharashtra,Osmanabad,108,202,310
2020-05-01,Maharashtra,Solapur,661,915,1576
2020-05-01,Maharashtra,Satara,423,598,1021
2020-05-01,Maharashtra,Ratnagiri,144,186,330
2020-05-01,Maharashtra,Sindhudurg,220,221,441
2020-05-01,Maharashtra,Kolhapur,284,365,649
2020-05-01,Maharashtra,Sangli,83,121,204
2020-05-01,Maharashtra,Palghar,385,527,912
2020-06-01,Maharashtra,Nandurbar,217,358,575
2020-06-01,Maharashtra,Dhule,319,538,857
2020-06-01,Maharashtra,Jalgaon,465,785,1250
2020-06-01,Maharashtra,Buldana,174,282,456
2020-06-01,Maharashtra,Akola,363,598,961
2020-06-01,Maharashtra,Washim,73,131,204
2020-06-01,Maharashtra,Amravati,472,820,1292
2020-06-01,Maharashtra,Wardha,178,336,514
2020-06-01,Maharashtra,Nagpur,913,1313,2226
2020-06-01,Maharashtra,Bhandara,128,171,299
2020-06-01,Maharashtra,Gondiya,79,117,196
2020-06-01,Maharashtra,Gadchiroli,113,172,285
2020-06-01,Maharashtra,Chandrapur,198,330,528
2020-06-01,Maharashtra,Yavatmal,132,265,397
2020-06-01,Maharashtra,Nanded,313,626,939
2020-06-01,Maharashtra,Hingoli,55,123,178
2020-06-01,Maharashtra,Parbhani,158,319,477
2020-06-01,Maharashtra,Jalna,133,319,452
2020-06-01,Maharashtra,Aurangabad,447,814,1261
2020-06-01,Maharashtra,Nashik,840,1314,2154
2020-06-01,Maharashtra,Thane,2620,3957,6577
2020-06-01,Maharashtra,Mumbai Suburban,3120,4671,7791
2020-06-01,Maharashtra,Mumbai,1669,2515,4184
2020-06-01,Maharashtra,Raigarh,177,240,417
2020-06-01,Maharashtra,Pune,1754,2555,4309
2020-06-01,Maharashtra,Ahmednagar,443,677,1120
2020-06-01,Maharashtra,Beed,167,341,508
2020-06-01,Maharashtra,Latur,242,464,706
2020-06-01,Maharashtra,Osmanabad,102,178,280
2020-06-01,Maharashtra,Solapur,539,939,1478
2020-06-01,Maharashtra,Satara,409,581,990
2020-06-01,Maharashtra,Ratnagiri,125,185,310
2020-06-01,Maharashtra,Sindhudurg,204,237,441
2020-06-01,Maharashtra,Kolhapur,273,345,618
2020-06-01,Maharashtra,Sangli,71,108,179
2020-06-01,Maharashtra,Palghar,437,650,1087
2020-07-01,Maharashtra,Nandurbar,233,427,660
2020-07-01,Maharashtra,Dhule,387,688,1075
2020-07-01,Maharashtra,Jalgaon,497,843,1340
2020-07-01,Maharashtra,Buldana,223,388,611
2020-07-01,Maharashtra,Akola,349,567,916
2020-07-01,Maharashtra,Washim,101,173,274
2020-07-01,Maharashtra,Amravati,505,963,1468
2020-07-01,Maharashtra,Wardha,217,360,577
2020-07-01,Maharashtra,Nagpur,1061,1707,2768
2020-07-01,Maharashtra,Bhandara,137,196,333
2020-07-01,Maharashtra,Gondiya,74,119,193
2020-07-01,Maharashtra,Gadchiroli,127,214,341
2020-07-01,Maharashtra,Chandrapur,219,376,595
2020-07-01,Maharashtra,Yavatmal,161,287,448
2020-07-01,Maharashtra,Nanded,436,849,1285
2020-07-01,Maharashtra,Hingoli,61,141,202
2020-07-01,Maharashtra,Parbhani,212,420,632
2020-07-01,Maharashtra,Jalna,204,420,624
2020-07-01,Maharashtra,Aurangabad,441,901,1342
2020-07-01,Maharashtra,Nashik,979,1643,2622
2020-07-01,Maharashtra,Thane,2466,4436,6902
2020-07-01,Maharashtra,Mumbai Suburban,2477,3629,6106
2020-07-01,Maharashtra,Mumbai,1487,2423,3910
2020-07-01,Maharashtra,Raigarh,258,512,770
2020-07-01,Maharashtra,Pune,2366,4051,6417
2020-07-01,Maharashtra,Ahmednagar,650,1053,1703
2020-07-01,Maharashtra,Beed,184,463,647
2020-07-01,Maharashtra,Latur,338,763,1101
2020-07-01,Maharashtra,Osmanabad,141,285,426
2020-07-01,Maharashtra,Solapur,527,851,1378
2020-07-01,Maharashtra,Satara,480,708,1188
2020-07-01,Maharashtra,Ratnagiri,150,243,393
2020-07-01,Maharashtra,Sindhudurg,192,282,474
2020-07-01,Maharashtra,Kolhapur,356,508,864
2020-07-01,Maharashtra,Sangli,80,127,207
2020-07-01,Maharashtra,Palghar,473,872,1345
2020-08-01,Maharashtra,Nandurbar,301,518,819
2020-08-01,Maharashtra,Dhule,520,917,1437
2020-08-01,Maharashtra,Jalgaon,624,1147,1771
2020-08-01,Maharashtra,Buldana,210,359,569
2020-08-01,Maharashtra,Akola,366,673,1039
2020-08-01,Maharashtra,Washim,117,216,333
2020-08-01,Maharashtra,Amravati,662,1284,1946
2020-08-01,Maharashtra,Wardha,246,425,671
2020-08-01,Maharashtra,Nagpur,1725,3031,4756
2020-08-01,Maharashtra,Bhandara,144,230,374
2020-08-01,Maharashtra,Gondiya,78,193,271
2020-08-01,Maharashtra,Gadchiroli,148,240,388
2020-08-01,Maharashtra,Chandrapur,254,480,734
2020-08-01,Maharashtra,Yavatmal,199,401,600
2020-08-01,Maharashtra,Nanded,587,1141,1728
2020-08-01,Maharashtra,Hingoli,87,152,239
2020-08-01,Maharashtra,Parbhani,267,594,861
2020-08-01,Maharashtra,Jalna,204,418,622
2020-08-01,Maharashtra,Aurangabad,437,1044,1481
2020-08-01,Maharashtra,Nashik,1190,2013,3203
2020-08-01,Maharashtra,Thane,1985,3434,5419
2020-08-01,Maharashtra,Mumbai Suburban,2447,3497,5944
2020-08-01,Maharashtra,Mumbai,1442,2360,3802
2020-08-01,Maharashtra,Raigarh,245,517,762
2020-08-01,Maharashtra,Pune,2584,4903,7487
2020-08-01,Maharashtra,Ahmednagar,815,1460,2275
2020-08-01,Maharashtra,Beed,272,665,937
2020-08-01,Maharashtra,Latur,401,919,1320
2020-08-01,Maharashtra,Osmanabad,169,343,512
2020-08-01,Maharashtra,Solapur,520,1008,1528
2020-08-01,Maharashtra,Satara,698,1165,1863
2020-08-01,Maharashtra,Ratnagiri,190,289,479
2020-08-01,Maharashtra,Sindhudurg,203,307,510
2020-08-01,Maharashtra,Kolhapur,636,1156,1792
2020-08-01,Maharashtra,Sangli,149,227,376
2020-08-01,Maharashtra,Palghar,494,878,1372
2020-09-01,Maharashtra,Nandurbar,237,424,661
2020-09-01,Maharashtra,Dhule,487,895,1382
2020-09-01,Maharashtra,Jalgaon,632,1151,1783
2020-09-01,Maharashtra,Buldana,201,426,627
2020-09-01,Maharashtra,Akola,457,739,1196
2020-09-01,Maharashtra,Washim,114,242,356
2020-09-01,Maharashtra,Amravati,733,1530,2263
2020-09-01,Maharashtra,Wardha,343,678,1021
2020-09-01,Maharashtra,Nagpur,1983,3778,5761
2020-09-01,Maharashtra,Bhandara,231,456,687
2020-09-01,Maharashtra,Gondiya,148,276,424
2020-09-01,Maharashtra,Gadchiroli,154,286,440
2020-09-01,Maharashtra,Chandrapur,370,760,1130
2020-09-01,Maharashtra,Yavatmal,317,750,1067
2020-09-01,Maharashtra,Nanded,555,1218,1773
2020-09-01,Maharashtra,Hingoli,61,185,246
2020-09-01,Maharashtra,Parbhani,239,513,752
2020-09-01,Maharashtra,Jalna,189,423,612
2020-09-01,Maharashtra,Aurangabad,441,1036,1477
2020-09-01,Maharashtra,Nashik,1195,2317,3512
2020-09-01,Maharashtra,Thane,2106,3498,5604
2020-09-01,Maharashtra,Mumbai Suburban,2631,3561,6192
2020-09-01,Maharashtra,Mumbai,1545,2322,3867
2020-09-01,Maharashtra,Raigarh,266,495,761
2020-09-01,Maharashtra,Pune,2834,5384,8218
2020-09-01,Maharashtra,Ahmednagar,819,1554,2373
2020-09-01,Maharashtra,Beed,244,648,892
2020-09-01,Maharashtra,Latur,405,945,1350
2020-09-01,Maharashtra,Osmanabad,189,422,611
2020-09-01,Maharashtra,Solapur,602,1170,1772
2020-09-01,Maharashtra,Satara,948,1673,2621
2020-09-01,Maharashtra,Ratnagiri,192,284,476
2020-09-01,Maharashtra,Sindhudurg,260,396,656
2020-09-01,Maharashtra,Kolhapur,681,1067,1748
2020-09-01,Maharashtra,Sangli,286,488,774
2020-09-01,Maharashtra,Palghar,496,872,1368
2020-10-01,Maharashtra,Nandurbar,226,376,602
2020-10-01,Maharashtra,Dhule,364,683,1047
2020-10-01,Maharashtra,Jalgaon,385,759,1144
2020-10-01,Maharashtra,Buldana,186,342,528
2020-10-01,Maharashtra,Akola,355,634,989
2020-10-01,Maharashtra,Washim,83,168,251
2020-10-01,Maharashtra,Amravati,607,1104,1711
2020-10-01,Maharashtra,Wardha,297,552,849
2020-10-01,Maharashtra,Nagpur,1255,2280,3535
2020-10-01,Maharashtra,Bhandara,154,302,456
2020-10-01,Maharashtra,Gondiya,112,255,367
2020-10-01,Maharashtra,Gadchiroli,206,397,603
2020-10-01,Maharashtra,Chandrapur,336,587,923
2020-10-01,Maharashtra,Yavatmal,207,391,598
2020-10-01,Maharashtra,Nanded,375,897,1272
2020-10-01,Maharashtra,Hingoli,58,156,214
2020-10-01,Maharashtra,Parbhani,218,421,639
2020-10-01,Maharashtra,Jalna,167,456,623
2020-10-01,Maharashtra,Aurangabad,393,906,1299
2020-10-01,Maharashtra,Nashik,996,1772,2768
2020-10-01,Maharashtra,Thane,1903,3088,4991
2020-10-01,Maharashtra,Mumbai Suburban,2479,3583,6062
2020-10-01,Maharashtra,Mumbai,1495,2285,3780
2020-10-01,Maharashtra,Raigarh,243,309,552
2020-10-01,Maharashtra,Pune,2062,3640,5702
2020-10-01,Maharashtra,Ahmednagar,669,1144,1813
2020-10-01,Maharashtra,Beed,211,507,718
2020-10-01,Maharashtra,Latur,373,799,1172
2020-10-01,Maharashtra,Osmanabad,150,339,489
2020-10-01,Maharashtra,Solapur,567,997,1564
2020-10-01,Maharashtra,Satara,664,1111,1775
2020-10-01,Maharashtra,Ratnagiri,121,167,288
2020-10-01,Maharashtra,Sindhudurg,255,295,550
2020-10-01,Maharashtra,Kolhapur,375,582,957
2020-10-01,Maharashtra,Sangli,126,203,329
2020-10-01,Maharashtra,Palghar,408,692,1100
2020-11-01,Maharashtra,Nandurbar,220,387,607
2020-11-01,Maharashtra,Dhule,358,559,917
2020-11-01,Maharashtra,Jalgaon,359,645,1004
2020-11-01,Maharashtra,Buldana,182,306,488
2020-11-01,Maharashtra,Akola,375,563,938
2020-11-01,Maharashtra,Washim,76,142,218
2020-11-01,Maharashtra,Amravati,512,988,1500
2020-11-01,Maharashtra,Wardha,270,520,790
2020-11-01,Maharashtra,Nagpur,1261,2207,3468
2020-11-01,Maharashtra,Bhandara,147,286,433
2020-11-01,Maharashtra,Gondiya,118,246,364
2020-11-01,Maharashtra,Gadchiroli,156,347,503
2020-11-01,Maharashtra,Chandrapur,297,558,855
2020-11-01,Maharashtra,Yavatmal,195,328,523
2020-11-01,Maharashtra,Nanded,373,801,1174
2020-11-01,Maharashtra,Hingoli,42,145,187
2020-11-01,Maharashtra,Parbhani,198,364,562
2020-11-01,Maharashtra,Jalna,149,326,475
2020-11-01,Maharashtra,Aurangabad,354,652,1006
2020-11-01,Maharashtra,Nashik,846,1469,2315
2020-11-01,Maharashtra,Thane,1532,2422,3954
2020-11-01,Maharashtra,Mumbai Suburban,2150,2782,4932
2020-11-01,Maharashtra,Mumbai,1207,1875,3082
2020-11-01,Maharashtra,Raigarh,220,274,494
2020-11-01,Maharashtra,Pune,1888,3139,5027
2020-11-01,Maharashtra,Ahmednagar,599,1003,1602
2020-11-01,Maharashtra,Beed,201,440,641
2020-11-01,Maharashtra,Latur,303,598,901
2020-11-01,Maharashtra,Osmanabad,120,230,350
2020-11-01,Maharashtra,Solapur,471,890,1361
2020-11-01,Maharashtra,Satara,550,939,1489
2020-11-01,Maharashtra,Ratnagiri,115,138,253
2020-11-01,Maharashtra,Sindhudurg,254,305,559
2020-11-01,Maharashtra,Kolhapur,376,515,891
2020-11-01,Maharashtra,Sangli,98,180,278
2020-11-01,Maharashtra,Palghar,364,572,936
2020-12-01,Maharashtra,Nandurbar,230,422,652
2020-12-01,Maharashtra,Dhule,324,578,902
2020-12-01,Maharashtra,Jalgaon,328,627,955
2020-12-01,Maharashtra,Buldana,184,279,463
2020-12-01,Maharashtra,Akola,313,580,893
2020-12-01,Maharashtra,Washim,90,147,237
2020-12-01,Maharashtra,Amravati,466,887,1353
2020-12-01,Maharashtra,Wardha,251,505,756
2020-12-01,Maharashtra,Nagpur,1300,2163,3463
2020-12-01,Maharashtra,Bhandara,205,284,489
2020-12-01,Maharashtra,Gondiya,111,207,318
2020-12-01,Maharashtra,Gadchiroli,179,283,462
2020-12-01,Maharashtra,Chandrapur,334,514,848
2020-12-01,Maharashtra,Yavatmal,167,343,510
2020-12-01,Maharashtra,Nanded,347,678,1025
2020-12-01,Maharashtra,Hingoli,60,101,161
2020-12-01,Maharashtra,Parbhani,180,339,519
2020-12-01,Maharashtra,Jalna,143,310,453
2020-12-01,Maharashtra,Aurangabad,467,927,1394
2020-12-01,Maharashtra,Nashik,976,1645,2621
2020-12-01,Maharashtra,Thane,1574,2312,3886
2020-12-01,Maharashtra,Mumbai Suburban,2028,2640,4668
2020-12-01,Maharashtra,Mumbai,1232,1943,3175
2020-12-01,Maharashtra,Raigarh,170,271,441
2020-12-01,Maharashtra,Pune,1883,3152,5035
2020-12-01,Maharashtra,Ahmednagar,669,1093,1762
2020-12-01,Maharashtra,Beed,201,410,611
2020-12-01,Maharashtra,Latur,322,555,877
2020-12-01,Maharashtra,Osmanabad,117,238,355
2020-12-01,Maharashtra,Solapur,534,909,1443
2020-12-01,Maharashtra,Satara,535,889,1424
2020-12-01,Maharashtra,Ratnagiri,127,120,247
2020-12-01,Maharashtra,Sindhudurg,208,294,502
2020-12-01,Maharashtra,Kolhapur,325,505,830
2020-12-01,Maharashtra,Sangli,121,131,252
2020-12-01,Maharashtra,Palghar,387,497,884
2021-01-01,Maharashtra,Nandurbar,214,369,583
2021-01-01,Maharashtra,Dhule,307,561,868
2021-01-01,Maharashtra,Jalgaon,359,633,992
2021-01-01,Maharashtra,Buldana,146,312,458
2021-01-01,Maharashtra,Akola,273,538,811
2021-01-01,Maharashtra,Washim,67,133,200
2021-01-01,Maharashtra,Amravati,488,962,1450
2021-01-01,Maharashtra,Wardha,213,416,629
2021-01-01,Maharashtra,Nagpur,1249,1998,3247
2021-01-01,Maharashtra,Bhandara,158,243,401
2021-01-01,Maharashtra,Gondiya,96,141,237
2021-01-01,Maharashtra,Gadchiroli,118,189,307
2021-01-01,Maharashtra,Chandrapur,265,413,678
2021-01-01,Maharashtra,Yavatmal,138,303,441
2021-01-01,Maharashtra,Nanded,331,629,960
2021-01-01,Maharashtra,Hingoli,45,98,143
2021-01-01,Maharashtra,Parbhani,163,281,444
2021-01-01,Maharashtra,Jalna,134,273,407
2021-01-01,Maharashtra,Aurangabad,395,842,1237
2021-01-01,Maharashtra,Nashik,855,1449,2304
2021-01-01,Maharashtra,Thane,1472,2147,3619
2021-01-01,Maharashtra,Mumbai Suburban,2008,2674,4682
2021-01-01,Maharashtra,Mumbai,1227,1847,3074
2021-01-01,Maharashtra,Raigarh,147,270,417
2021-01-01,Maharashtra,Pune,1653,2758,4411
2021-01-01,Maharashtra,Ahmednagar,554,1003,1557
2021-01-01,Maharashtra,Beed,180,317,497
2021-01-01,Maharashtra,Latur,254,520,774
2021-01-01,Maharashtra,Osmanabad,90,213,303
2021-01-01,Maharashtra,Solapur,479,860,1339
2021-01-01,Maharashtra,Satara,465,713,1178
2021-01-01,Maharashtra,Ratnagiri,125,102,227
2021-01-01,Maharashtra,Sindhudurg,212,282,494
2021-01-01,Maharashtra,Kolhapur,311,468,779
2021-01-01,Maharashtra,Sangli,129,177,306
2021-01-01,Maharashtra,Palghar,367,539,906
2021-02-01,Maharashtra,Nandurbar,165,307,472
2021-02-01,Maharashtra,Dhule,290,564,854
2021-02-01,Maharashtra,Jalgaon,346,581,927
2021-02-01,Maharashtra,Buldana,124,243,367
2021-02-01,Maharashtra,Akola,285,541,826
2021-02-01,Maharashtra,Washim,63,137,200
2021-02-01,Maharashtra,Amravati,464,1062,1526
2021-02-01,Maharashtra,Wardha,189,361,550
2021-02-01,Maharashtra,Nagpur,1123,1837,2960
2021-02-01,Maharashtra,Bhandara,90,168,258
2021-02-01,Maharashtra,Gondiya,74,124,198
2021-02-01,Maharashtra,Gadchiroli,97,199,296
2021-02-01,Maharashtra,Chandrapur,216,328,544
2021-02-01,Maharashtra,Yavatmal,123,283,406
2021-02-01,Maharashtra,Nanded,290,515,805
2021-02-01,Maharashtra,Hingoli,44,85,129
2021-02-01,Maharashtra,Parbhani,142,287,429
2021-02-01,Maharashtra,Jalna,112,271,383
2021-02-01,Maharashtra,Aurangabad,336,714,1050
2021-02-01,Maharashtra,Nashik,866,1385,2251
2021-02-01,Maharashtra,Thane,1324,1983,3307
2021-02-01,Maharashtra,Mumbai Suburban,1860,2333,4193
2021-02-01,Maharashtra,Mumbai,1182,1790,2972
2021-02-01,Maharashtra,Raigarh,142,222,364
2021-02-01,Maharashtra,Pune,1524,2499,4023
2021-02-01,Maharashtra,Ahmednagar,493,841,1334
2021-02-01,Maharashtra,Beed,118,271,389
2021-02-01,Maharashtra,Latur,234,478,712
2021-02-01,Maharashtra,Osmanabad,102,183,285
2021-02-01,Maharashtra,Solapur,378,691,1069
2021-02-01,Maharashtra,Satara,357,609,966
2021-02-01,Maharashtra,Ratnagiri,97,111,208
2021-02-01,Maharashtra,Sindhudurg,185,252,437
2021-02-01,Maharashtra,Kolhapur,282,410,692
2021-02-01,Maharashtra,Sangli,101,146,247
2021-02-01,Maharashtra,Palghar,320,442,762
2021-03-01,Maharashtra,Nandurbar,295,536,831
2021-03-01,Maharashtra,Dhule,658,1013,1671
2021-03-01,Maharashtra,Jalgaon,931,1647,2578
2021-03-01,Maharashtra,Buldana,201,416,617
2021-03-01,Maharashtra,Akola,389,783,1172
2021-03-01,Maharashtra,Washim,103,200,303
2021-03-01,Maharashtra,Amravati,603,1247,1850
2021-03-01,Maharashtra,Wardha,259,609,868
2021-03-01,Maharashtra,Nagpur,1836,2800,4636
2021-03-01,Maharashtra,Bhandara,131,205,336
2021-03-01,Maharashtra,Gondiya,67,129,196
2021-03-01,Maharashtra,Gadchiroli,130,200,330
2021-03-01,Maharashtra,Chandrapur,206,377,583
2021-03-01,Maharashtra,Yavatmal,226,480,706
2021-03-01,Maharashtra,Nanded,493,978,1471
2021-03-01,Maharashtra,Hingoli,72,170,242
2021-03-01,Maharashtra,Parbhani,252,469,721
2021-03-01,Maharashtra,Jalna,212,485,697
2021-03-01,Maharashtra,Aurangabad,519,1244,1763
2021-03-01,Maharashtra,Nashik,1292,2324,3616
2021-03-01,Maharashtra,Thane,1695,2475,4170
2021-03-01,Maharashtra,Mumbai Suburban,2230,2923,5153
2021-03-01,Maharashtra,Mumbai,1266,2003,3269
2021-03-01,Maharashtra,Raigarh,152,266,418
2021-03-01,Maharashtra,Pune,2188,3765,5953
2021-03-01,Maharashtra,Ahmednagar,605,1111,1716
2021-03-01,Maharashtra,Beed,143,318,461
2021-03-01,Maharashtra,Latur,238,607,845
2021-03-01,Maharashtra,Osmanabad,108,223,331
2021-03-01,Maharashtra,Solapur,463,872,1335
2021-03-01,Maharashtra,Satara,422,680,1102
2021-03-01,Maharashtra,Ratnagiri,90,93,183
2021-03-01,Maharashtra,Sindhudurg,196,231,427
2021-03-01,Maharashtra,Kolhapur,253,371,624
2021-03-01,Maharashtra,Sangli,94,139,233
2021-03-01,Maharashtra,Palghar,309,481,790
2021-04-01,Maharashtra,Nandurbar,945,1821,2766
2021-04-01,Maharashtra,Dhule,1249,2087,3336
2021-04-01,Maharashtra,Jalgaon,1488,2229,3717
2021-04-01,Maharashtra,Buldana,366,663,1029
2021-04-01,Maharashtra,Akola,474,884,1358
2021-04-01,Maharashtra,Washim,210,363,573
2021-04-01,Maharashtra,Amravati,742,1590,2332
2021-04-01,Maharashtra,Wardha,689,1327,2016
2021-04-01,Maharashtra,Nagpur,4871,8004,12875
2021-04-01,Maharashtra,Bhandara,828,1414,2242
2021-04-01,Maharashtra,Gondiya,474,765,1239
2021-04-01,Maharashtra,Gadchiroli,266,560,826
2021-04-01,Maharashtra,Chandrapur,625,1288,1913
2021-04-01,Maharashtra,Yavatmal,486,1031,1517
2021-04-01,Maharashtra,Nanded,1107,2281,3388
2021-04-01,Maharashtra,Hingoli,234,473,707
2021-04-01,Maharashtra,Parbhani,627,1142,1769
2021-04-01,Maharashtra,Jalna,364,825,1189
2021-04-01,Maharashtra,Aurangabad,825,1868,2693
2021-04-01,Maharashtra,Nashik,3678,6095,9773
2021-04-01,Maharashtra,Thane,3862,6286,10148
2021-04-01,Maharashtra,Mumbai Suburban,4161,5947,10108
2021-04-01,Maharashtra,Mumbai,1996,2927,4923
2021-04-01,Maharashtra,Raigarh,338,649,987
2021-04-01,Maharashtra,Pune,5295,8912,14207
2021-04-01,Maharashtra,Ahmednagar,1870,3209,5079
2021-04-01,Maharashtra,Beed,342,839,1181
2021-04-01,Maharashtra,Latur,871,1900,2771
2021-04-01,Maharashtra,Osmanabad,423,769,1192
2021-04-01,Maharashtra,Solapur,1052,1796,2848
2021-04-01,Maharashtra,Satara,884,1572,2456
2021-04-01,Maharashtra,Ratnagiri,165,243,408
2021-04-01,Maharashtra,Sindhudurg,295,435,730
2021-04-01,Maharashtra,Kolhapur,357,501,858
2021-04-01,Maharashtra,Sangli,229,263,492
2021-04-01,Maharashtra,Palghar,771,1306,2077
2021-05-01,Maharashtra,Nandurbar,351,704,1055
2021-05-01,Maharashtra,Dhule,629,1056,1685
2021-05-01,Maharashtra,Jalgaon,863,1271,2134
2021-05-01,Maharashtra,Buldana,362,599,961
2021-05-01,Maharashtra,Akola,549,937,1486
2021-05-01,Maharashtra,Washim,208,360,568
2021-05-01,Maharashtra,Amravati,927,1899,2826
2021-05-01,Maharashtra,Wardha,549,969,1518
2021-05-01,Maharashtra,Nagpur,2417,4058,6475
2021-05-01,Maharashtra,Bhandara,314,582,896
2021-05-01,Maharashtra,Gondiya,239,446,685
2021-05-01,Maharashtra,Gadchiroli,275,597,872
2021-05-01,Maharashtra,Chandrapur,574,1218,1792
2021-05-01,Maharashtra,Yavatmal,427,802,1229
2021-05-01,Maharashtra,Nanded,431,1006,1437
2021-05-01,Maharashtra,Hingoli,113,302,415
2021-05-01,Maharashtra,Parbhani,365,764,1129
2021-05-01,Maharashtra,Jalna,289,595,884
2021-05-01,Maharashtra,Aurangabad,684,1622,2306
2021-05-01,Maharashtra,Nashik,2366,3899,6265
2021-05-01,Maharashtra,Thane,2741,4126,6867
2021-05-01,Maharashtra,Mumbai Suburban,3245,4217,7462
2021-05-01,Maharashtra,Mumbai,1660,2347,4007
2021-05-01,Maharashtra,Raigarh,364,648,1012
2021-05-01,Maharashtra,Pune,3905,6658,10563
2021-05-01,Maharashtra,Ahmednagar,1891,3119,5010
2021-05-01,Maharashtra,Beed,519,1165,1684
2021-05-01,Maharashtra,Latur,804,1500,2304
2021-05-01,Maharashtra,Osmanabad,587,911,1498
2021-05-01,Maharashtra,Solapur,1149,2082,3231
2021-05-01,Maharashtra,Satara,1255,2009,3264
2021-05-01,Maharashtra,Ratnagiri,219,296,515
2021-05-01,Maharashtra,Sindhudurg,467,783,1250
2021-05-01,Maharashtra,Kolhapur,690,1008,1698
2021-05-01,Maharashtra,Sangli,288,480,768
2021-05-01,Maharashtra,Palghar,669,1032,1701
